Gen,Resource,Stamp,TimeStamp_Start,TimeStamp_End,Duration,Indiv_id
0,1,FirstEvaluation,943791750861,944585087817,793336956,-1
0,1,STEP,944585238616,944591020265,5781649,-1
1,1,STEP,944591110265,944595630925,4520660,-1
2,1,STEP,944595707324,944600501682,4794358,-1
3,1,STEP,944600589082,944604725045,4135963,-1
4,1,STEP,944604805045,944608224115,3419070,-1
5,1,STEP,944608301814,944612843374,4541560,-1
6,1,STEP,944612922074,944617252036,4329962,-1
7,1,STEP,944617330135,944621478399,4148264,-1
8,1,STEP,944621562498,944625052068,3489570,-1
9,1,STEP,944625127967,944629978724,4850757,-1
10,1,STEP,944630056224,944633583393,3527169,-1
11,1,STEP,944633659292,944638416351,4757059,-1
12,1,STEP,944638494650,944643367907,4873257,-1
13,1,STEP,944643446307,944647793368,4347061,-1
14,1,STEP,944647880268,944652481127,4600859,-1
15,1,STEP,944652557527,944655792898,3235371,-1
16,1,STEP,944655869198,944659925562,4056364,-1
17,1,STEP,944660004862,944664126025,4121163,-1
18,1,STEP,944664205825,944667735694,3529869,-1
19,1,STEP,944667815493,944670906966,3091473,-1
20,1,STEP,944670984065,944675150629,4166564,-1
21,1,STEP,944675229528,944678751097,3521569,-1
22,1,STEP,944678828897,944681839270,3010373,-1
23,1,STEP,944681921470,944685904435,3982965,-1
24,1,STEP,944685986234,944690206697,4220463,-1
25,1,STEP,944690285797,944694190462,3904665,-1
26,1,STEP,944694269762,944698431125,4161363,-1
27,1,STEP,944698511325,944702605689,4094364,-1
28,1,STEP,944702685188,944706207457,3522269,-1
29,1,STEP,944706287756,944710945416,4657660,-1
30,1,STEP,944711026515,944714712883,3686368,-1
31,1,STEP,944714793282,944718511149,3717867,-1
32,1,STEP,944718597449,944722344516,3747067,-1
33,1,STEP,944722423415,944725695987,3272572,-1
34,1,STEP,944725781486,944729302355,3520869,-1
35,1,STEP,944729383254,944732710525,3327271,-1
36,1,STEP,944732790524,944736246794,3456270,-1
37,1,STEP,944736326394,944739385567,3059173,-1
38,1,STEP,944739464266,944742269842,2805576,-1
39,1,STEP,944742345741,944745413914,3068173,-1
40,1,STEP,944745494113,944748811884,3317771,-1
41,1,STEP,944748891784,944752208555,3316771,-1
42,1,STEP,944752288054,944756091421,3803367,-1
43,1,STEP,944756171620,944759263593,3091973,-1
44,1,STEP,944759343492,944762444465,3100973,-1
45,1,STEP,944762526164,944766049233,3523069,-1
46,1,STEP,944766131533,944769139006,3007473,-1
47,1,STEP,944769216906,944772052581,2835675,-1
48,1,STEP,944772129680,944775166054,3036374,-1
49,1,STEP,944775246153,944778047828,2801675,-1
50,1,STEP,944778126028,944781399299,3273271,-1
51,1,STEP,944781477998,944784984468,3506470,-1
52,1,STEP,944785066467,944788645436,3578969,-1
53,1,STEP,944788741135,944791856607,3115472,-1
54,1,STEP,944791959907,944795588175,3628268,-1
55,1,STEP,944795675874,944799548040,3872166,-1
56,1,STEP,944799637439,944803546005,3908566,-1
57,1,STEP,944803666504,944806529479,2862975,-1
58,1,STEP,944806653378,944809294655,2641277,-1
59,1,STEP,944809405954,944811946632,2540678,-1
60,1,STEP,944812057031,944814831206,2774175,-1
61,1,STEP,944814941105,944818270076,3328971,-1
62,1,STEP,944818381575,944821282950,2901375,-1
63,1,STEP,944821392449,944824549921,3157472,-1
64,1,STEP,944824661220,944828321388,3660168,-1
65,1,STEP,944828432987,944832031756,3598769,-1
66,1,STEP,944832144355,944834615033,2470678,-1
67,1,STEP,944834728432,944837739206,3010774,-1
68,1,STEP,944837848305,944840768579,2920274,-1
69,1,STEP,944840880078,944843587055,2706977,-1
70,1,STEP,944843697154,944846288531,2591377,-1
71,1,STEP,944846399130,944849416504,3017374,-1
72,1,STEP,944849527103,944852781774,3254671,-1
73,1,STEP,944852892873,944856490742,3597869,-1
74,1,STEP,944856602341,944859832113,3229772,-1
75,1,STEP,944859901912,944862989985,3088073,-1
76,1,STEP,944863059784,944865765861,2706077,-1
77,1,STEP,944865835860,944868722535,2886675,-1
78,1,STEP,944868793334,944871697209,2903875,-1
79,1,STEP,944871769508,944874516984,2747476,-1
80,1,STEP,944874587883,944877579657,2991774,-1
81,1,STEP,944877646157,944880330333,2684176,-1
82,1,STEP,944880435332,944883568005,3132673,-1
83,1,STEP,944883677204,944886574478,2897274,-1
84,1,STEP,944886681878,944889808450,3126572,-1
85,1,STEP,944889944749,944892843724,2898975,-1
86,1,STEP,944892955923,944896111695,3155772,-1
87,1,STEP,944896225894,944899272867,3046973,-1
88,1,STEP,944899385366,944903055634,3670268,-1
89,1,STEP,944903189333,944907084499,3895166,-1
90,1,STEP,944907194198,944910635268,3441070,-1
91,1,STEP,944910729567,944914263636,3534069,-1
92,1,STEP,944914395735,944917946504,3550769,-1
93,1,STEP,944918033903,944921460073,3426170,-1
94,1,STEP,944921585472,944925754636,4169164,-1
95,1,STEP,944925894734,944931044189,5149455,-1
96,1,STEP,944931176088,944935413851,4237763,-1
97,1,STEP,944935540650,944939619414,4078764,-1
98,1,STEP,944939746113,944943822377,4076264,-1
99,1,STEP,944943943476,944947101949,3158473,-1
100,1,STEP,944947172748,944949717226,2544478,-1
101,1,STEP,944949785125,944952614500,2829375,-1
102,1,STEP,944952684900,944956085670,3400770,-1
103,1,STEP,944956157969,944959134343,2976374,-1
104,1,STEP,944959208043,944961857820,2649777,-1
105,1,STEP,944961945719,944965183990,3238271,-1
106,1,STEP,944965254790,944968284963,3030173,-1
107,1,STEP,944968355263,944971204938,2849675,-1
108,1,STEP,944971274837,944974591208,3316371,-1
109,1,STEP,944974664107,944977609382,2945275,-1
110,1,STEP,944977676181,944980698855,3022674,-1
111,1,STEP,944980768654,944983827927,3059273,-1
112,1,STEP,944983898427,944986687002,2788575,-1
113,1,STEP,944986756602,944989389579,2632977,-1
114,1,STEP,944989459978,944992499651,3039673,-1
115,1,STEP,944992570051,944995263327,2693276,-1
116,1,STEP,944995332927,944998489399,3156472,-1
117,1,STEP,944998560198,945001619471,3059273,-1
118,1,STEP,945001689171,945005047141,3357970,-1
119,1,STEP,945005117241,945008444712,3327471,-1
120,1,STEP,945008515611,945011837282,3321671,-1
121,1,STEP,945011908481,945015141653,3233172,-1
122,1,STEP,945015212853,945018211126,2998273,-1
123,1,STEP,945018282526,945021184400,2901874,-1
124,1,STEP,945021254500,945024373872,3119372,-1
125,1,STEP,945024447072,945027183748,2736676,-1
126,1,STEP,945027250047,945030347020,3096973,-1
127,1,STEP,945030421019,945033804590,3383571,-1
128,1,STEP,945033924489,945037088561,3164072,-1
129,1,STEP,945037156960,945040600630,3443670,-1
130,1,STEP,945040731329,945043766503,3035174,-1
131,1,STEP,945043844702,945047528270,3683568,-1
132,1,STEP,945047633169,945050851641,3218472,-1
133,1,STEP,945050934440,945053905114,2970674,-1
134,1,STEP,945053993113,945057620381,3627268,-1
135,1,STEP,945057697781,945061205950,3508169,-1
136,1,STEP,945061349949,945064945017,3595068,-1
137,1,STEP,945065017917,945068538686,3520769,-1
138,1,STEP,945068609585,945071579659,2970074,-1
139,1,STEP,945071649359,945074545933,2896574,-1
140,1,STEP,945074615233,945077662606,3047373,-1
141,1,STEP,945077732005,945080880178,3148173,-1
142,1,STEP,945080948977,945084604545,3655568,-1
143,1,STEP,945084674845,945087687118,3012273,-1
144,1,STEP,945087756518,945090509093,2752575,-1
145,1,STEP,945090620892,945094883455,4262563,-1
146,1,STEP,945094966354,945097915929,2949575,-1
147,1,STEP,945097989228,945100722904,2733676,-1
148,1,STEP,945100793103,945103641979,2848876,-1
149,1,STEP,945103712278,945107050149,3337871,-1
150,1,STEP,945107121648,945110163121,3041473,-1
151,1,STEP,945110232921,945113537892,3304971,-1
152,1,STEP,945113607991,945116729064,3121073,-1
153,1,STEP,945116795263,945119450540,2655277,-1
154,1,STEP,945119521440,945122448714,2927274,-1
155,1,STEP,945122519513,945125646686,3127173,-1
156,1,STEP,945125714485,945128304963,2590478,-1
157,1,STEP,945128372862,945131421135,3048273,-1
158,1,STEP,945131489935,945134995604,3505669,-1
159,1,STEP,945135066103,945138155876,3089773,-1
160,1,STEP,945138225676,945141641546,3415870,-1
161,1,STEP,945141710745,945144909517,3198772,-1
162,1,STEP,945144979417,945148062690,3083273,-1
163,1,STEP,945148132989,945150928665,2795676,-1
164,1,STEP,945150997164,945154169536,3172372,-1
165,1,STEP,945154237436,945157215010,2977574,-1
166,1,STEP,945157283309,945160226583,2943274,-1
167,1,STEP,945160296183,945163300256,3004073,-1
168,1,STEP,945163369156,945166558628,3189472,-1
169,1,STEP,945166627927,945169436903,2808976,-1
170,1,STEP,945169506402,945172383677,2877275,-1
171,1,STEP,945172457176,945175461450,3004274,-1
172,1,STEP,945175530149,945178207826,2677677,-1
173,1,STEP,945178277925,945181374598,3096673,-1
174,1,STEP,945181443698,945184585470,3141772,-1
175,1,STEP,945184654869,945187406745,2751876,-1
176,1,STEP,945187475845,945190730616,3254771,-1
177,1,STEP,945190800916,945193891289,3090373,-1
178,1,STEP,945193961688,945196571365,2609677,-1
179,1,STEP,945196640265,945200055135,3414870,-1
180,1,STEP,945200124734,945202822810,2698076,-1
181,1,STEP,945202892110,945205576586,2684476,-1
182,1,STEP,945205645386,945208491561,2846175,-1
183,1,STEP,945208561460,945211523934,2962474,-1
184,1,STEP,945211594934,945214990004,3395070,-1
185,1,STEP,945215059903,945218298475,3238572,-1
186,1,STEP,945218369274,945220875552,2506278,-1
187,1,STEP,945220943352,945223886626,2943274,-1
188,1,STEP,945223956325,945226906800,2950475,-1
189,1,STEP,945226976099,945229570076,2593977,-1
190,1,STEP,945229639876,945232395152,2755276,-1
191,1,STEP,945232462851,945235440725,2977874,-1
192,1,STEP,945235511424,945238059402,2547978,-1
193,1,STEP,945238128401,945240962877,2834476,-1
194,1,STEP,945241032776,945243785252,2752476,-1
195,1,STEP,945243854751,945246710026,2855275,-1
196,1,STEP,945246780126,945250876890,4096764,-1
197,1,STEP,945250983489,945254179361,3195872,-1
198,1,STEP,945254252060,945257290034,3037974,-1
199,1,STEP,945257359733,945260492606,3132873,-1
200,1,STEP,945260563405,945263419680,2856275,-1
201,1,STEP,945263489179,945266417054,2927875,-1
202,1,STEP,945266488353,945269693625,3205272,-1
203,1,STEP,945269765824,945272709499,2943675,-1
204,1,STEP,945272781398,945276061269,3279871,-1
205,1,STEP,945276132369,945279178342,3045973,-1
206,1,STEP,945279274841,945283164807,3889966,-1
207,1,STEP,945283237707,945286333879,3096172,-1
208,1,STEP,945286405579,945289223654,2818075,-1
209,1,STEP,945289292654,945292385326,3092672,-1
210,1,STEP,945292456126,945294986504,2530378,-1
211,1,STEP,945295055503,945298189876,3134373,-1
212,1,STEP,945298260975,945301418347,3157372,-1
213,1,STEP,945301488847,945305014316,3525469,-1
214,1,STEP,945305086015,945308394686,3308671,-1
215,1,STEP,945308466486,945311239861,2773375,-1
216,1,STEP,945311309861,945314733831,3423970,-1
217,1,STEP,945314805630,945317811304,3005674,-1
218,1,STEP,945317889803,945321110175,3220372,-1
219,1,STEP,945321178374,945324009150,2830776,-1
220,1,STEP,945324080049,945327446920,3366871,-1
221,1,STEP,945327516619,945330437993,2921374,-1
222,1,STEP,945330507793,945334106961,3599168,-1
223,1,STEP,945334178661,945337581331,3402670,-1
224,1,STEP,945337653530,945340788603,3135073,-1
225,1,STEP,945340859802,945343949675,3089873,-1
226,1,STEP,945344020375,945346921049,2900674,-1
227,1,STEP,945346992649,945349962623,2969974,-1
228,1,STEP,945350033622,945352720998,2687376,-1
229,1,STEP,945352789898,945355720172,2930274,-1
230,1,STEP,945355792371,945359050943,3258572,-1
231,1,STEP,945359122142,945362256315,3134173,-1
232,1,STEP,945362329814,945365036191,2706377,-1
233,1,STEP,945365107590,945368157063,3049473,-1
234,1,STEP,945368230463,945370929739,2699276,-1
235,1,STEP,945371000638,945374825205,3824567,-1
236,1,STEP,945374900604,945377753979,2853375,-1
237,1,STEP,945377824679,945381267149,3442470,-1
238,1,STEP,945381338148,945384044324,2706176,-1
239,1,STEP,945384114324,945387221496,3107172,-1
240,1,STEP,945387292896,945390541867,3248971,-1
241,1,STEP,945390613367,945393712640,3099273,-1
242,1,STEP,945393784339,945396731213,2946874,-1
243,1,STEP,945396802313,945399892585,3090272,-1
244,1,STEP,945399963485,945403241856,3278371,-1
245,1,STEP,945403314056,945406963024,3648968,-1
246,1,STEP,945407036623,945409373103,2336480,-1
247,1,STEP,945409443002,945412068179,2625177,-1
248,1,STEP,945412137978,945415038353,2900375,-1
249,1,STEP,945415109452,945418111026,3001574,-1
250,1,STEP,945418183225,945421802694,3619469,-1
251,1,STEP,945421888993,945424928666,3039673,-1
252,1,STEP,945424999766,945428173438,3173672,-1
253,1,STEP,945428243237,945430850215,2606978,-1
254,1,STEP,945430920114,945433956587,3036473,-1
255,1,STEP,945434028787,945437025360,2996573,-1
256,1,STEP,945437131260,945440170433,3039173,-1
257,1,STEP,945440241632,945443508504,3266872,-1
258,1,STEP,945443581603,945446188480,2606877,-1
259,1,STEP,945446259280,945449405052,3145772,-1
260,1,STEP,945449474852,945453006621,3531769,-1
261,1,STEP,945453078720,945455955795,2877075,-1
262,1,STEP,945456027094,945458916369,2889275,-1
263,1,STEP,945458986068,945462783035,3796967,-1
264,1,STEP,945462854834,945465850208,2995374,-1
265,1,STEP,945465929407,945468369486,2440079,-1
266,1,STEP,945468438186,945471591858,3153672,-1
267,1,STEP,945471664557,945475027828,3363271,-1
268,1,STEP,945475099827,945477509306,2409479,-1
269,1,STEP,945477577506,945480591879,3014373,-1
270,1,STEP,945480663579,945484071449,3407870,-1
271,1,STEP,945484144948,945487423419,3278471,-1
272,1,STEP,945487496619,945490650391,3153772,-1
273,1,STEP,945490722190,945493131169,2408979,-1
274,1,STEP,945493201669,945495797446,2595777,-1
275,1,STEP,945495867645,945499078417,3210772,-1
276,1,STEP,945499150717,945502322989,3172272,-1
277,1,STEP,945502396188,945505243863,2847675,-1
278,1,STEP,945505314063,945508439635,3125572,-1
279,1,STEP,945508513135,945511551108,3037973,-1
280,1,STEP,945511623308,945514765880,3142572,-1
281,1,STEP,945514839779,945517383857,2544078,-1
282,1,STEP,945517450457,945520284732,2834275,-1
283,1,STEP,945520358031,945523313605,2955574,-1
284,1,STEP,945523386905,945526489677,3102772,-1
285,1,STEP,945526563677,945529662450,3098773,-1
286,1,STEP,945529732149,945532909421,3177272,-1
287,1,STEP,945532980321,945535889695,2909374,-1
288,1,STEP,945535959095,945538992968,3033873,-1
289,1,STEP,945539139367,945541898843,2759476,-1
290,1,STEP,945541974142,945544846017,2871875,-1
291,1,STEP,945544913316,945547623192,2709876,-1
292,1,STEP,945547690792,945550907964,3217172,-1
293,1,STEP,945550980963,945553965737,2984774,-1
294,1,STEP,945554036636,945557094310,3057674,-1
295,1,STEP,945557164409,945560536379,3371970,-1
296,1,STEP,945560608679,945563364955,2756276,-1
297,1,STEP,945563437254,945566377228,2939974,-1
298,1,STEP,945566446128,945569538201,3092073,-1
299,1,STEP,945569606700,945572404276,2797576,-1
300,1,STEP,945572475175,945575505948,3030773,-1
301,1,STEP,945575577948,945578039826,2461878,-1
302,1,STEP,945578110926,945580988400,2877474,-1
303,1,STEP,945581058700,945584068573,3009873,-1
304,1,STEP,945584141373,945587197646,3056273,-1
305,1,STEP,945587269045,945590308619,3039574,-1
306,1,STEP,945590380318,945593657989,3277671,-1
307,1,STEP,945593729289,945596441665,2712376,-1
308,1,STEP,945596513565,945599565938,3052373,-1
309,1,STEP,945599640537,945602104716,2464179,-1
310,1,STEP,945602176215,945605566885,3390670,-1
311,1,STEP,945605637785,945608894056,3256271,-1
312,1,STEP,945608967655,945612051429,3083774,-1
313,1,STEP,945612123328,945615249501,3126173,-1
314,1,STEP,945615324900,945618157575,2832675,-1
315,1,STEP,945618230574,945621229948,2999374,-1
316,1,STEP,945621302648,945624150523,2847875,-1
317,1,STEP,945624221722,945627001898,2780176,-1
318,1,STEP,945627074397,945630214970,3140573,-1
319,1,STEP,945630287969,945633524241,3236272,-1
320,1,STEP,945633597640,945636662313,3064673,-1
321,1,STEP,945636735012,945640085183,3350171,-1
322,1,STEP,945640158982,945643316855,3157873,-1
323,1,STEP,945643392454,945646743725,3351271,-1
324,1,STEP,945646816824,945649510401,2693577,-1
325,1,STEP,945649577500,945652756872,3179372,-1
326,1,STEP,945652829072,945656211742,3382670,-1
327,1,STEP,945656285341,945659175016,2889675,-1
328,1,STEP,945659245815,945661809393,2563578,-1
329,1,STEP,945661886992,945664909566,3022574,-1
330,1,STEP,945664982465,945668061338,3078873,-1
331,1,STEP,945668132238,945671133511,3001273,-1
332,1,STEP,945671206011,945673627190,2421179,-1
333,1,STEP,945673696389,945676821762,3125373,-1
334,1,STEP,945676893261,945679852935,2959674,-1
335,1,STEP,945679924634,945682605111,2680477,-1
336,1,STEP,945682675410,945685727984,3052574,-1
337,1,STEP,945685799483,945688665658,2866175,-1
338,1,STEP,945688737257,945691794031,3056774,-1
339,1,STEP,945691866030,945694665305,2799275,-1
340,1,STEP,945694737105,945697957677,3220572,-1
341,1,STEP,945698029076,945701198948,3169872,-1
342,1,STEP,945701277248,945704478520,3201272,-1
343,1,STEP,945704554019,945707764291,3210272,-1
344,1,STEP,945707835790,945710983263,3147473,-1
345,1,STEP,945711055062,945713845038,2789976,-1
346,1,STEP,945713923437,945716833411,2909974,-1
347,1,STEP,945716904311,945719911084,3006773,-1
348,1,STEP,945719984484,945723340054,3355570,-1
349,1,STEP,945723413854,945726634326,3220472,-1
350,1,STEP,945726709325,945729674299,2964974,-1
351,1,STEP,945729745698,945732719272,2973574,-1
352,1,STEP,945732791472,945736002344,3210872,-1
353,1,STEP,945736075043,945738963618,2888575,-1
354,1,STEP,945739035117,945741938392,2903275,-1
355,1,STEP,945742011691,945745539660,3527969,-1
356,1,STEP,945745612759,945748617533,3004774,-1
357,1,STEP,945748686133,945752032503,3346370,-1
358,1,STEP,945752108203,945755130176,3021973,-1
359,1,STEP,945755203876,945758225249,3021373,-1
360,1,STEP,945758296848,945761681619,3384771,-1
361,1,STEP,945761754218,945764666893,2912675,-1
362,1,STEP,945764738292,945767332969,2594677,-1
363,1,STEP,945767404569,945769907947,2503378,-1
364,1,STEP,945769979446,945772874921,2895475,-1
365,1,STEP,945772945420,945776035393,3089973,-1
366,1,STEP,945776106993,945779375364,3268371,-1
367,1,STEP,945779448163,945782343938,2895775,-1
368,1,STEP,945782414537,945785233013,2818476,-1
369,1,STEP,945785304912,945788215787,2910875,-1
370,1,STEP,945788286286,945790672965,2386679,-1
371,1,STEP,945790743464,945793850437,3106973,-1
372,1,STEP,945793931037,945797083109,3152072,-1
373,1,STEP,945797154008,945799943784,2789776,-1
374,1,STEP,945800015583,945802862258,2846675,-1
375,1,STEP,945802934058,945805945731,3011673,-1
376,1,STEP,945806020331,945808986505,2966174,-1
377,1,STEP,945809060704,945812175977,3115273,-1
378,1,STEP,945812248676,945814949353,2700677,-1
379,1,STEP,945815021752,945817883627,2861875,-1
380,1,STEP,945817966926,945821008800,3041874,-1
381,1,STEP,945821080999,945823628877,2547878,-1
382,1,STEP,945823700776,945826928948,3228172,-1
383,1,STEP,945827000647,945829841322,2840675,-1
384,1,STEP,945829934621,945832995795,3061174,-1
385,1,STEP,945833067794,945835967069,2899275,-1
386,1,STEP,945836038568,945839240340,3201772,-1
387,1,STEP,945839314139,945842407712,3093573,-1
388,1,STEP,945842481312,945845570885,3089573,-1
389,1,STEP,945845643084,945848332460,2689376,-1
390,1,STEP,945848406760,945851464933,3058173,-1
391,1,STEP,945851537632,945854524006,2986374,-1
392,1,STEP,945854600006,945857750278,3150272,-1
393,1,STEP,945857823177,945860890850,3067673,-1
394,1,STEP,945860962450,945863993323,3030873,-1
395,1,STEP,945864065523,945867429893,3364370,-1
396,1,STEP,945867503793,945870533566,3029773,-1
397,1,STEP,945870606265,945873312542,2706277,-1
398,1,STEP,945873382541,945876391715,3009174,-1
399,1,STEP,945876463714,945879958984,3495270,-1
400,1,STEP,945880032083,945882983357,2951274,-1
401,1,STEP,945883056156,945885863632,2807476,-1
402,1,STEP,945885942331,945888282011,2339680,-1
403,1,STEP,945888349110,945891388384,3039274,-1
404,1,STEP,945891459983,945894039760,2579777,-1
405,1,STEP,945894164259,945897033734,2869475,-1
406,1,STEP,945897104133,945899843610,2739477,-1
407,1,STEP,945899914309,945903091281,3176972,-1
408,1,STEP,945903162480,945906404052,3241572,-1
409,1,STEP,945906476151,945909787622,3311471,-1
410,1,STEP,945909857922,945912686397,2828475,-1
411,1,STEP,945912753897,945915966568,3212671,-1
412,1,STEP,945916038268,945918749844,2711576,-1
413,1,STEP,945918821043,945922275813,3454770,-1
414,1,STEP,945922348513,945925209087,2860574,-1
415,1,STEP,945925279787,945927652866,2373079,-1
416,1,STEP,945927723465,945930805539,3082074,-1
417,1,STEP,945930878338,945933499315,2620977,-1
418,1,STEP,945933570714,945936949685,3378971,-1
419,1,STEP,945937053184,945940172857,3119673,-1
420,1,STEP,945940256756,945943043031,2786275,-1
421,1,STEP,945943124031,945945997706,2873675,-1
422,1,STEP,945946082505,945949438975,3356470,-1
423,1,STEP,945949546874,945952683347,3136473,-1
424,1,STEP,945952773546,945955564022,2790476,-1
425,1,STEP,945955646121,945958671595,3025474,-1
426,1,STEP,945958758094,945962076565,3318471,-1
427,1,STEP,945962178664,945964746441,2567777,-1
428,1,STEP,945964831841,945968381610,3549769,-1
429,1,STEP,945968470509,945971591182,3120673,-1
430,1,STEP,945971680481,945974513456,2832975,-1
431,1,STEP,945974605155,945977675228,3070073,-1
432,1,STEP,945977763028,945980572203,2809175,-1
433,1,STEP,945980645202,945984209071,3563869,-1
434,1,STEP,945984295870,945987109346,2813476,-1
435,1,STEP,945987196345,945990549016,3352671,-1
436,1,STEP,945990631115,945993494190,2863075,-1
437,1,STEP,945993577489,945996730261,3152772,-1
438,1,STEP,945996814561,946000321730,3507169,-1
439,1,STEP,946000406029,946003688501,3282472,-1
440,1,STEP,946003760300,946006769374,3009074,-1
441,1,STEP,946006845273,946009505050,2659777,-1
442,1,STEP,946009587249,946012865420,3278171,-1
443,1,STEP,946012941920,946016718287,3776367,-1
444,1,STEP,946016801386,946020094257,3292871,-1
445,1,STEP,946020169256,946022762434,2593178,-1
446,1,STEP,946022841333,946026234803,3393470,-1
447,1,STEP,946026314003,946029132078,2818075,-1
448,1,STEP,946029210177,946032108452,2898275,-1
449,1,STEP,946032181551,946035051626,2870075,-1
450,1,STEP,946035135225,946037958901,2823676,-1
451,1,STEP,946038034400,946041093473,3059073,-1
452,1,STEP,946041175672,946044417944,3242272,-1
453,1,STEP,946044498443,946047672216,3173773,-1
454,1,STEP,946047745415,946050984787,3239372,-1
455,1,STEP,946051057986,946054169359,3111373,-1
456,1,STEP,946054240658,946057293831,3053173,-1
457,1,STEP,946057366731,946060368404,3001673,-1
458,1,STEP,946060441404,946063440878,2999474,-1
459,1,STEP,946063511877,946066727449,3215572,-1
460,1,STEP,946066798648,946069823422,3024774,-1
461,1,STEP,946069906521,946073074593,3168072,-1
462,1,STEP,946073147793,946076203566,3055773,-1
463,1,STEP,946076273265,946079552337,3279072,-1
464,1,STEP,946079624636,946082851508,3226872,-1
465,1,STEP,946082937607,946086512376,3574769,-1
466,1,STEP,946086585575,946089879846,3294271,-1
467,1,STEP,946089952246,946093197617,3245371,-1
468,1,STEP,946093268117,946096655187,3387070,-1
469,1,STEP,946096726586,946100233256,3506670,-1
470,1,STEP,946100307755,946103947823,3640068,-1
471,1,STEP,946104021322,946106995696,2974374,-1
472,1,STEP,946107067396,946110772463,3705067,-1
473,1,STEP,946110847263,946114205233,3357970,-1
474,1,STEP,946114278433,946118050300,3771867,-1
475,1,STEP,946118137999,946121129773,2991774,-1
476,1,STEP,946121241672,946124273945,3032273,-1
477,1,STEP,946124387844,946127647916,3260072,-1
478,1,STEP,946127762715,946131311484,3548769,-1
479,1,STEP,946131425483,946134661554,3236071,-1
480,1,STEP,946134732854,946137812927,3080073,-1
481,1,STEP,946137904026,946140952499,3048473,-1
482,1,STEP,946141025299,946143495777,2470478,-1
483,1,STEP,946143565976,946146481351,2915375,-1
484,1,STEP,946146552450,946149409725,2857275,-1
485,1,STEP,946149480924,946152881595,3400671,-1
486,1,STEP,946152953594,946155703270,2749676,-1
487,1,STEP,946155773569,946158604545,2830976,-1
488,1,STEP,946158676044,946162089614,3413570,-1
489,1,STEP,946162162713,946165364485,3201772,-1
490,1,STEP,946165436385,946168335559,2899174,-1
491,1,STEP,946168407459,946171124135,2716676,-1
492,1,STEP,946171195234,946174608705,3413471,-1
493,1,STEP,946174684404,946177260281,2575877,-1
494,1,STEP,946177329981,946180077057,2747076,-1
495,1,STEP,946180148456,946182836733,2688277,-1
496,1,STEP,946182907032,946185841206,2934174,-1
497,1,STEP,946185919306,946188866080,2946774,-1
498,1,STEP,946188937379,946192755546,3818167,-1
499,1,STEP,946192828845,946195976718,3147873,-1
500,1,STEP,946196047117,946199315488,3268371,-1
501,1,STEP,946199387988,946202136164,2748176,-1
502,1,STEP,946202209163,946205217037,3007874,-1
503,1,STEP,946205288036,946208408009,3119973,-1
504,1,STEP,946208480108,946211463382,2983274,-1
505,1,STEP,946211535981,946214466056,2930075,-1
506,1,STEP,946214538055,946217285831,2747776,-1
507,1,STEP,946217355730,946220380904,3025174,-1
508,1,STEP,946220452703,946223479677,3026974,-1
509,1,STEP,946223551176,946226424151,2872975,-1
510,1,STEP,946226495950,946229377825,2881875,-1
511,1,STEP,946229448625,946232455898,3007273,-1
512,1,STEP,946232563197,946235524671,2961474,-1
513,1,STEP,946235595171,946238279447,2684276,-1
514,1,STEP,946238349847,946241327321,2977474,-1
515,1,STEP,946241397720,946244174496,2776776,-1
516,1,STEP,946244244695,946247466467,3221772,-1
517,1,STEP,946247538366,946250509340,2970974,-1
518,1,STEP,946250579940,946253908710,3328770,-1
519,1,STEP,946253978710,946257067483,3088773,-1
520,1,STEP,946257138082,946260507353,3369271,-1
521,1,STEP,946260580152,946263809424,3229272,-1
522,1,STEP,946263881823,946267119595,3237772,-1
523,1,STEP,946267191694,946270444666,3252972,-1
524,1,STEP,946270516265,946273749637,3233372,-1
525,1,STEP,946273820736,946277258106,3437370,-1
526,1,STEP,946277331205,946280369079,3037874,-1
527,1,STEP,946280438978,946283263054,2824076,-1
528,1,STEP,946283333653,946286179028,2845375,-1
529,1,STEP,946286249027,946290334692,4085665,-1
530,1,STEP,946290409391,946293570863,3161472,-1
531,1,STEP,946293642863,946296980933,3338070,-1
532,1,STEP,946297053333,946299830509,2777176,-1
533,1,STEP,946299902408,946303132180,3229772,-1
534,1,STEP,946303205979,946305997955,2791976,-1
535,1,STEP,946306069854,946309169827,3099973,-1
536,1,STEP,946309241626,946312106501,2864875,-1
537,1,STEP,946312176700,946314831377,2654677,-1
538,1,STEP,946314902177,946318719543,3817366,-1
539,1,STEP,946318793543,946321278421,2484878,-1
540,1,STEP,946321347520,946324234595,2887075,-1
541,1,STEP,946324306594,946327661965,3355371,-1
542,1,STEP,946327733764,946329990445,2256681,-1
543,1,STEP,946330061044,946333106917,3045873,-1
544,1,STEP,946333177617,946336093591,2915974,-1
545,1,STEP,946336164890,946339531761,3366871,-1
546,1,STEP,946339603860,946342315937,2712077,-1
547,1,STEP,946342387936,946346822397,4434461,-1
548,1,STEP,946346896097,946350464465,3568368,-1
549,1,STEP,946350539065,946353706837,3167772,-1
550,1,STEP,946353779836,946357072007,3292171,-1
551,1,STEP,946357145407,946360563577,3418170,-1
552,1,STEP,946360637976,946363607650,2969674,-1
553,1,STEP,946363681150,946366928921,3247771,-1
554,1,STEP,946367002421,946370465390,3462969,-1
555,1,STEP,946370539890,946373695962,3156072,-1
556,1,STEP,946373767161,946376583037,2815876,-1
557,1,STEP,946376653436,946379383912,2730476,-1
558,1,STEP,946379454312,946382789582,3335270,-1
559,1,STEP,946382862282,946385643957,2781675,-1
560,1,STEP,946385712857,946388307334,2594477,-1
561,1,STEP,946388375633,946390898611,2522978,-1
562,1,STEP,946390967411,946393563188,2595777,-1
563,1,STEP,946393630688,946396815460,3184772,-1
564,1,STEP,946396887259,946400335329,3448070,-1
565,1,STEP,946400406328,946403410802,3004474,-1
566,1,STEP,946403482001,946406385376,2903375,-1
567,1,STEP,946406455775,946409658647,3202872,-1
568,1,STEP,946409732447,946412539422,2806975,-1
569,1,STEP,946412609421,946415656895,3047474,-1
570,1,STEP,946415728794,946419080265,3351471,-1
571,1,STEP,946419153164,946422469235,3316071,-1
572,1,STEP,946422542634,946425370510,2827876,-1
573,1,STEP,946425440109,946428401083,2960974,-1
574,1,STEP,946428472283,946431545756,3073473,-1
575,1,STEP,946431617855,946434710528,3092673,-1
576,1,STEP,946434782927,946437584103,2801176,-1
577,1,STEP,946437654802,946440765475,3110673,-1
578,1,STEP,946440842574,946443973447,3130873,-1
579,1,STEP,946444044646,946447154419,3109773,-1
580,1,STEP,946447227418,946450113693,2886275,-1
581,1,STEP,946450183293,946452842169,2658876,-1
582,1,STEP,946452911769,946456185040,3273271,-1
583,1,STEP,946456256739,946458902816,2646077,-1
584,1,STEP,946458973616,946461857990,2884374,-1
585,1,STEP,946461938690,946464894364,2955674,-1
586,1,STEP,946464964663,946468240534,3275871,-1
587,1,STEP,946468312934,946471474706,3161772,-1
588,1,STEP,946471546706,946474938076,3391370,-1
589,1,STEP,946475009875,946477895050,2885175,-1
590,1,STEP,946477965849,946481341720,3375871,-1
591,1,STEP,946481419719,946484654991,3235272,-1
592,1,STEP,946484730190,946488390358,3660168,-1
593,1,STEP,946488463757,946491417232,2953475,-1
594,1,STEP,946491489131,946494082908,2593777,-1
595,1,STEP,946494155008,946496989083,2834075,-1
596,1,STEP,946497059782,946499717459,2657677,-1
597,1,STEP,946499789258,946502625233,2835975,-1
598,1,STEP,946502707533,946505597007,2889474,-1
599,1,STEP,946505670307,946509059477,3389170,-1
600,1,STEP,946509133677,946512626646,3492969,-1
601,1,STEP,946512702345,946516065216,3362871,-1
602,1,STEP,946516139415,946519090389,2950974,-1
603,1,STEP,946519160489,946522274562,3114073,-1
604,1,STEP,946522345761,946525116837,2771076,-1
605,1,STEP,946525185536,946528635006,3449470,-1
606,1,STEP,946528707805,946531567980,2860175,-1
607,1,STEP,946531638680,946534681353,3042673,-1
608,1,STEP,946534752052,946537734626,2982574,-1
609,1,STEP,946537806526,946540928498,3121972,-1
610,1,STEP,946541000098,946544049471,3049373,-1
611,1,STEP,946544119970,946546706748,2586778,-1
612,1,STEP,946546776047,946549612122,2836075,-1
613,1,STEP,946549681122,946552348198,2667076,-1
614,1,STEP,946552419198,946555716769,3297571,-1
615,1,STEP,946555784368,946558744442,2960074,-1
616,1,STEP,946558815042,946561582617,2767575,-1
617,1,STEP,946561653417,946564180895,2527478,-1
618,1,STEP,946564251494,946567325067,3073573,-1
619,1,STEP,946567396067,946570526839,3130772,-1
620,1,STEP,946570597539,946573654012,3056473,-1
621,1,STEP,946573725011,946576501787,2776776,-1
622,1,STEP,946576571486,946579386962,2815476,-1
623,1,STEP,946579458961,946582576534,3117573,-1
624,1,STEP,946582648033,946585934104,3286071,-1
625,1,STEP,946586007004,946589251575,3244571,-1
626,1,STEP,946589322675,946592247149,2924474,-1
627,1,STEP,946592317148,946595640019,3322871,-1
628,1,STEP,946595712719,946598935291,3222572,-1
629,1,STEP,946599008290,946601945464,2937174,-1
630,1,STEP,946602016264,946605556933,3540669,-1
631,1,STEP,946605629532,946608498907,2869375,-1
632,1,STEP,946608570806,946611568380,2997574,-1
633,1,STEP,946611638879,946614660553,3021674,-1
634,1,STEP,946614734252,946617699426,2965174,-1
635,1,STEP,946617769926,946620661400,2891474,-1
636,1,STEP,946620733400,946623224678,2491278,-1
637,1,STEP,946623294077,946626775647,3481570,-1
638,1,STEP,946626849046,946630060318,3211272,-1
639,1,STEP,946630133517,946633063392,2929875,-1
640,1,STEP,946633136491,946636132165,2995674,-1
641,1,STEP,946636204864,946639284037,3079173,-1
642,1,STEP,946639356737,946642419210,3062473,-1
643,1,STEP,946642492109,946645501483,3009374,-1
644,1,STEP,946645574882,946649930244,4355362,-1
645,1,STEP,946650005544,946653168616,3163072,-1
646,1,STEP,946653242815,946656416287,3173472,-1
647,1,STEP,946656490287,946660013156,3522869,-1
648,1,STEP,946660086455,946663253428,3166973,-1
649,1,STEP,946663327827,946667029494,3701667,-1
650,1,STEP,946667102894,946670244966,3142072,-1
651,1,STEP,946670319266,946673145541,2826275,-1
652,1,STEP,946673218040,946676521311,3303271,-1
653,1,STEP,946676594511,946679361487,2766976,-1
654,1,STEP,946679434886,946682709557,3274671,-1
655,1,STEP,946682782557,946686160027,3377470,-1
656,1,STEP,946686233226,946689429598,3196372,-1
657,1,STEP,946689502098,946692629370,3127272,-1
658,1,STEP,946692701770,946695480945,2779175,-1
659,1,STEP,946695553845,946699007515,3453670,-1
660,1,STEP,946699081614,946702571783,3490169,-1
661,1,STEP,946702645783,946706081153,3435370,-1
662,1,STEP,946706154852,946709298825,3143973,-1
663,1,STEP,946709370324,946712731794,3361470,-1
664,1,STEP,946712806094,946715974266,3168172,-1
665,1,STEP,946716047765,946719655634,3607869,-1
666,1,STEP,946719730433,946722882906,3152473,-1
667,1,STEP,946722956905,946726085678,3128773,-1
668,1,STEP,946726158677,946729049352,2890675,-1
669,1,STEP,946729123551,946731784028,2660477,-1
670,1,STEP,946731857527,946735793593,3936066,-1
671,1,STEP,946735868692,946739320862,3452170,-1
672,1,STEP,946739389961,946742918030,3528069,-1
673,1,STEP,946743069829,946746728997,3659168,-1
674,1,STEP,946746802496,946749754970,2952474,-1
675,1,STEP,946749829070,946753139741,3310671,-1
676,1,STEP,946753212440,946756109815,2897375,-1
677,1,STEP,946756182614,946759423886,3241272,-1
678,1,STEP,946759497485,946762075963,2578478,-1
679,1,STEP,946762149562,946765413033,3263471,-1
680,1,STEP,946765485033,946769053202,3568169,-1
681,1,STEP,946769126601,946772427972,3301371,-1
682,1,STEP,946772501771,946776053440,3551669,-1
683,1,STEP,946776130940,946779474010,3343070,-1
684,1,STEP,946779547810,946782667782,3119972,-1
685,1,STEP,946782739782,946786291351,3551569,-1
686,1,STEP,946786365150,946789283024,2917874,-1
687,1,STEP,946789354124,946792870793,3516669,-1
688,1,STEP,946792944992,946795917766,2972774,-1
689,1,STEP,946795990266,946799326537,3336271,-1
690,1,STEP,946799400536,946802434209,3033673,-1
691,1,STEP,946802506509,946805706781,3200272,-1
692,1,STEP,946805779480,946809771045,3991565,-1
693,1,STEP,946809844144,946812562521,2718377,-1
694,1,STEP,946812634620,946815566094,2931474,-1
695,1,STEP,946815639494,946818506669,2867175,-1
696,1,STEP,946818579468,946821263545,2684077,-1
697,1,STEP,946821336244,946824175119,2838875,-1
698,1,STEP,946824247018,946827414391,3167373,-1
699,1,STEP,946827487490,946830768961,3281471,-1
700,1,STEP,946830841761,946834076432,3234671,-1
701,1,STEP,946834149032,946837323604,3174572,-1
702,1,STEP,946837391803,946840791474,3399671,-1
703,1,STEP,946840862373,946843644749,2782376,-1
704,1,STEP,946843716848,946847766713,4049865,-1
705,1,STEP,946847928611,946850738387,2809776,-1
706,1,STEP,946850809186,946853428363,2619177,-1
707,1,STEP,946853499462,946856547636,3048174,-1
708,1,STEP,946856619335,946859777007,3157672,-1
709,1,STEP,946859849007,946863070879,3221872,-1
710,1,STEP,946863143878,946866491449,3347571,-1
711,1,STEP,946866563448,946869327024,2763576,-1
712,1,STEP,946869398823,946872512596,3113773,-1
713,1,STEP,946872584895,946876598760,4013865,-1
714,1,STEP,946876733559,946879933031,3199472,-1
715,1,STEP,946880003530,946883336801,3333271,-1
716,1,STEP,946883409301,946886603373,3194072,-1
717,1,STEP,946886676572,946889477447,2800875,-1
718,1,STEP,946889548847,946892280723,2731876,-1
719,1,STEP,946892351922,946895469395,3117473,-1
720,1,STEP,946895542794,946898945265,3402471,-1
721,1,STEP,946899018264,946901985838,2967574,-1
722,1,STEP,946902057037,946905661806,3604769,-1
723,1,STEP,946905733205,946908784978,3051773,-1
724,1,STEP,946908857778,946912343447,3485669,-1
725,1,STEP,946912417347,946915776317,3358970,-1
726,1,STEP,946915850317,946918933090,3082773,-1
727,1,STEP,946919005689,946922194261,3188572,-1
728,1,STEP,946922267060,946925323434,3056374,-1
729,1,STEP,946925394833,946928891002,3496169,-1
730,1,STEP,946928963702,946932679469,3715767,-1
731,1,STEP,946932752569,946935952041,3199472,-1
732,1,STEP,946936023640,946938794616,2770976,-1
733,1,STEP,946938866515,946941757990,2891475,-1
734,1,STEP,946941829289,946944516366,2687077,-1
735,1,STEP,946944590665,946947338241,2747576,-1
736,1,STEP,946947410640,946950480914,3070274,-1
737,1,STEP,946950552413,946953289289,2736876,-1
738,1,STEP,946953360288,946956270563,2910275,-1
739,1,STEP,946956342862,946959518234,3175372,-1
740,1,STEP,946959591934,946962393609,2801675,-1
741,1,STEP,946962465009,946965265084,2800075,-1
742,1,STEP,946965335983,946968527656,3191673,-1
743,1,STEP,946968598855,946972300823,3701968,-1
744,1,STEP,946972394622,946975451895,3057273,-1
745,1,STEP,946975525894,946978942764,3416870,-1
746,1,STEP,946979016164,946982242236,3226072,-1
747,1,STEP,946982312835,946985190110,2877275,-1
748,1,STEP,946985261209,946988535480,3274271,-1
749,1,STEP,946988610880,946991309956,2699076,-1
750,1,STEP,946991395155,946994806126,3410971,-1
751,1,STEP,946994888825,946998411594,3522769,-1
752,1,STEP,946998525993,947001774665,3248672,-1
753,1,STEP,947001856164,947004568840,2712676,-1
754,1,STEP,947004665439,947008002410,3336971,-1
755,1,STEP,947008090409,947010755086,2664677,-1
756,1,STEP,947010839885,947013900558,3060673,-1
757,1,STEP,947013977958,947016771233,2793275,-1
758,1,STEP,947016851733,947020133104,3281371,-1
759,1,STEP,947020218803,947023674973,3456170,-1
760,1,STEP,947023760072,947026823045,3062973,-1
761,1,STEP,947026905745,947030351014,3445269,-1
762,1,STEP,947030433914,947033401088,2967174,-1
763,1,STEP,947033482487,947036343362,2860875,-1
764,1,STEP,947036429361,947039231837,2802476,-1
765,1,STEP,947039317336,947042137111,2819775,-1
766,1,STEP,947042218411,947045312983,3094572,-1
767,1,STEP,947045397983,947048797653,3399670,-1
768,1,STEP,947048892452,947051769527,2877075,-1
769,1,STEP,947051850526,947054245905,2395379,-1
770,1,STEP,947054350104,947057635076,3284972,-1
771,1,STEP,947057707775,947060721749,3013974,-1
772,1,STEP,947060793948,947063695523,2901575,-1
773,1,STEP,947063767922,947067297191,3529269,-1
774,1,STEP,947067370790,947070222665,2851875,-1
775,1,STEP,947070294465,947073296539,3002074,-1
776,1,STEP,947073367738,947076689709,3321971,-1
777,1,STEP,947076762808,947079615483,2852675,-1
778,1,STEP,947079687283,947082768056,3080773,-1
779,1,STEP,947082842755,947086038827,3196072,-1
780,1,STEP,947086112226,947088695404,2583178,-1
781,1,STEP,947088767203,947091134882,2367679,-1
782,1,STEP,947091206782,947094296155,3089373,-1
783,1,STEP,947094370054,947097222929,2852875,-1
784,1,STEP,947097295228,947100023605,2728377,-1
785,1,STEP,947100095904,947103164777,3068873,-1
786,1,STEP,947103238376,947106266850,3028474,-1
787,1,STEP,947106338149,947108899727,2561578,-1
788,1,STEP,947108969826,947112206098,3236272,-1
789,1,STEP,947112279197,947115392870,3113673,-1
790,1,STEP,947115465969,947118901039,3435070,-1
791,1,STEP,947118976039,947122084111,3108072,-1
792,1,STEP,947122157611,947125361083,3203472,-1
793,1,STEP,947125433382,947128568455,3135073,-1
794,1,STEP,947128642154,947132035624,3393470,-1
795,1,STEP,947132108824,947135222896,3114072,-1
796,1,STEP,947135296896,947138660066,3363170,-1
797,1,STEP,947138733566,947141351843,2618277,-1
798,1,STEP,947141422242,947144653214,3230972,-1
799,1,STEP,947144726713,947147625788,2899075,-1
800,1,STEP,947147697887,947150526463,2828576,-1
801,1,STEP,947150597562,947153952133,3354571,-1
802,1,STEP,947154025432,947156513010,2487578,-1
803,1,STEP,947156583410,947160222378,3638968,-1
804,1,STEP,947160295577,947163944445,3648868,-1
805,1,STEP,947164030344,947167095718,3065374,-1
806,1,STEP,947167176417,947170458588,3282171,-1
807,1,STEP,947170531387,947173604961,3073574,-1
808,1,STEP,947173677160,947176388336,2711176,-1
809,1,STEP,947176459136,947179361810,2902674,-1
810,1,STEP,947179433510,947182016287,2582777,-1
811,1,STEP,947182086986,947185207359,3120373,-1
812,1,STEP,947185279158,947188534730,3255572,-1
813,1,STEP,947188607429,947191563503,2956074,-1
814,1,STEP,947191635603,947194496378,2860775,-1
815,1,STEP,947194567377,947198289344,3721967,-1
816,1,STEP,947198362644,947202037812,3675168,-1
817,1,STEP,947202111411,947205378682,3267271,-1
818,1,STEP,947205452882,947208535355,3082473,-1
819,1,STEP,947208604454,947211664327,3059873,-1
820,1,STEP,947211737027,947214476903,2739876,-1
821,1,STEP,947214547502,947217562176,3014674,-1
822,1,STEP,947217634275,947220429351,2795076,-1
823,1,STEP,947220501150,947223665122,3163972,-1
824,1,STEP,947223738022,947226217500,2479478,-1
825,1,STEP,947226287799,947229010476,2722677,-1
826,1,STEP,947229081375,947232282947,3201572,-1
827,1,STEP,947232355046,947234817225,2462179,-1
828,1,STEP,947234887924,947237636800,2748876,-1
829,1,STEP,947237706299,947240595074,2888775,-1
830,1,STEP,947240663874,947243336450,2672576,-1
831,1,STEP,947243406750,947246153626,2746876,-1
832,1,STEP,947246224225,947249278698,3054473,-1
833,1,STEP,947249349498,947251984575,2635077,-1
834,1,STEP,947252053174,947255092447,3039273,-1
835,1,STEP,947255162447,947258032522,2870075,-1
836,1,STEP,947258104221,947261533091,3428870,-1
837,1,STEP,947261604690,947264555764,2951074,-1
838,1,STEP,947264626764,947267347240,2720476,-1
839,1,STEP,947267419239,947270064116,2644877,-1
840,1,STEP,947270135116,947273011990,2876874,-1
841,1,STEP,947273083390,947275991764,2908374,-1
842,1,STEP,947276063364,947278851339,2787975,-1
843,1,STEP,947278921739,947282175710,3253971,-1
844,1,STEP,947282287509,947285551981,3264472,-1
845,1,STEP,947285663980,947289038650,3374670,-1
846,1,STEP,947289151949,947292567019,3415070,-1
847,1,STEP,947292681218,947296820582,4139364,-1
848,1,STEP,947296898081,947300218552,3320471,-1
849,1,STEP,947300292152,947303856020,3563868,-1
850,1,STEP,947303929920,947306718695,2788775,-1
851,1,STEP,947306793295,947310084966,3291671,-1
852,1,STEP,947310158865,947313774834,3615969,-1
853,1,STEP,947313848033,947317115604,3267571,-1
854,1,STEP,947317196904,947320004279,2807375,-1
855,1,STEP,947320077479,947322986053,2908574,-1
856,1,STEP,947323061452,947325943027,2881575,-1
857,1,STEP,947326016627,947329115999,3099372,-1
858,1,STEP,947329189199,947332651268,3462069,-1
859,1,STEP,947332725168,947336079538,3354370,-1
860,1,STEP,947336153038,947339418209,3265171,-1
861,1,STEP,947339491209,947342695381,3204172,-1
862,1,STEP,947342765280,947346210750,3445470,-1
863,1,STEP,947346285249,947349720419,3435170,-1
864,1,STEP,947349794118,947353045990,3251872,-1
865,1,STEP,947353119889,947356296161,3176272,-1
866,1,STEP,947356369561,947359213336,2843775,-1
867,1,STEP,947359286635,947362406208,3119573,-1
868,1,STEP,947362480207,947365568580,3088373,-1
869,1,STEP,947365641680,947369181149,3539469,-1
870,1,STEP,947369256848,947372384421,3127573,-1
871,1,STEP,947372458620,947375270595,2811975,-1
872,1,STEP,947375344395,947378574966,3230571,-1
873,1,STEP,947378646066,947381696439,3050373,-1
874,1,STEP,947381768639,947384582914,2814275,-1
875,1,STEP,947384655113,947387775386,3120273,-1
876,1,STEP,947387849285,947390854159,3004874,-1
877,1,STEP,947390927458,947393817533,2890075,-1
878,1,STEP,947393898632,947397301903,3403271,-1
879,1,STEP,947397375802,947400333776,2957974,-1
880,1,STEP,947400407875,947403881145,3473270,-1
881,1,STEP,947403955244,947406713520,2758276,-1
882,1,STEP,947406785720,947409384297,2598577,-1
883,1,STEP,947409456196,947412296071,2839875,-1
884,1,STEP,947412368771,947415030247,2661476,-1
885,1,STEP,947415101447,947418503017,3401570,-1
886,1,STEP,947418576216,947421513991,2937775,-1
887,1,STEP,947421585090,947424696563,3111473,-1
888,1,STEP,947424768562,947427508338,2739776,-1
889,1,STEP,947427580738,947430928608,3347870,-1
890,1,STEP,947431002408,947434034081,3031673,-1
891,1,STEP,947434107680,947437494351,3386671,-1
892,1,STEP,947437565150,947440603524,3038374,-1
893,1,STEP,947440676123,947443078402,2402279,-1
894,1,STEP,947443149201,947446135875,2986674,-1
895,1,STEP,947446207775,947448910951,2703176,-1
896,1,STEP,947448982150,947452167022,3184872,-1
897,1,STEP,947452239022,947455439594,3200572,-1
898,1,STEP,947455513093,947458241869,2728776,-1
899,1,STEP,947458313369,947461850338,3536969,-1
900,1,STEP,947461937537,947464584714,2647177,-1
901,1,STEP,947464656013,947467806185,3150172,-1
902,1,STEP,947467877985,947470794359,2916374,-1
903,1,STEP,947470866459,947473999031,3132572,-1
904,1,STEP,947474072431,947477319602,3247171,-1
905,1,STEP,947477389702,947480220577,2830875,-1
906,1,STEP,947480292676,947483258950,2966274,-1
907,1,STEP,947483331850,947486618421,3286571,-1
908,1,STEP,947486693120,947489503996,2810876,-1
909,1,STEP,947489575495,947492260571,2685076,-1
910,1,STEP,947492332371,947495071947,2739576,-1
911,1,STEP,947495144846,947498630116,3485270,-1
912,1,STEP,947498704115,947501187493,2483378,-1
913,1,STEP,947501259093,947504371865,3112772,-1
914,1,STEP,947504443365,947507573537,3130172,-1
915,1,STEP,947507645737,947510782709,3136972,-1
916,1,STEP,947510856309,947513461886,2605577,-1
917,1,STEP,947513533885,947516034663,2500778,-1
918,1,STEP,947516107563,947519181836,3074273,-1
919,1,STEP,947519255835,947522842504,3586669,-1
920,1,STEP,947522917903,947526203074,3285171,-1
921,1,STEP,947526275574,947529669544,3393970,-1
922,1,STEP,947529741643,947532490319,2748676,-1
923,1,STEP,947532563119,947535870090,3306971,-1
924,1,STEP,947535943889,947538567466,2623577,-1
925,1,STEP,947538639365,947542045536,3406171,-1
926,1,STEP,947542119135,947545216808,3097673,-1
927,1,STEP,947545289007,947547892084,2603077,-1
928,1,STEP,947547964984,947550664660,2699676,-1
929,1,STEP,947550736160,947553818433,3082273,-1
930,1,STEP,947553898132,947556773207,2875075,-1
931,1,STEP,947556845206,947559575182,2729976,-1
932,1,STEP,947559644582,947563137451,3492869,-1
933,1,STEP,947563211050,947566433122,3222072,-1
934,1,STEP,947566504722,947569765893,3261171,-1
935,1,STEP,947569838292,947573417461,3579169,-1
936,1,STEP,947573489360,947576943730,3454370,-1
937,1,STEP,947577015530,947579912904,2897374,-1
938,1,STEP,947579984304,947583369974,3385670,-1
939,1,STEP,947583452773,947586174149,2721376,-1
940,1,STEP,947586246549,947589356322,3109773,-1
941,1,STEP,947589429121,947592433595,3004474,-1
942,1,STEP,947592506794,947595319469,2812675,-1
943,1,STEP,947595393169,947598266844,2873675,-1
944,1,STEP,947598339643,947601418916,3079273,-1
945,1,STEP,947601490915,947604822986,3332071,-1
946,1,STEP,947604899486,947608427455,3527969,-1
947,1,STEP,947608502354,947611589027,3086673,-1
948,1,STEP,947611661926,947614039006,2377080,-1
949,1,STEP,947614112305,947617794473,3682168,-1
950,1,STEP,947617865872,947621286742,3420870,-1
951,1,STEP,947621360741,947624394915,3034174,-1
952,1,STEP,947624467614,947627907884,3440270,-1
953,1,STEP,947627981083,947630399062,2417979,-1
954,1,STEP,947630469762,947633743133,3273371,-1
955,1,STEP,947633816432,947636703607,2887175,-1
956,1,STEP,947636776207,947640427175,3650968,-1
957,1,STEP,947640498874,947643659446,3160572,-1
958,1,STEP,947643732746,947646762419,3029673,-1
959,1,STEP,947646836418,947649735493,2899075,-1
960,1,STEP,947649806692,947652955665,3148973,-1
961,1,STEP,947653029064,947656484134,3455070,-1
962,1,STEP,947656559633,947659853505,3293872,-1
963,1,STEP,947659927904,947662859078,2931174,-1
964,1,STEP,947662931678,947666077750,3146072,-1
965,1,STEP,947666150549,947669671119,3520570,-1
966,1,STEP,947669743818,947672838091,3094273,-1
967,1,STEP,947672911390,947675782565,2871175,-1
968,1,STEP,947675856264,947678930838,3074574,-1
969,1,STEP,947679004037,947681574414,2570377,-1
970,1,STEP,947681645814,947684417890,2772076,-1
971,1,STEP,947684491589,947687451863,2960274,-1
972,1,STEP,947687526062,947690575036,3048974,-1
973,1,STEP,947690647835,947693722508,3074673,-1
974,1,STEP,947693838507,947697326377,3487870,-1
975,1,STEP,947697443875,947700699447,3255572,-1
976,1,STEP,947700814846,947704018918,3204072,-1
977,1,STEP,947704133817,947707042891,2909074,-1
978,1,STEP,947707127391,947710368762,3241371,-1
979,1,STEP,947710451862,947713668033,3216171,-1
980,1,STEP,947713770233,947716951105,3180872,-1
981,1,STEP,947717049904,947719880879,2830975,-1
982,1,STEP,947719983378,947723115951,3132573,-1
983,1,STEP,947723219050,947726464821,3245771,-1
984,1,STEP,947726581720,947729414196,2832476,-1
985,1,STEP,947729518195,947732441069,2922874,-1
986,1,STEP,947732540968,947735241345,2700377,-1
987,1,STEP,947735350844,947738655415,3304571,-1
988,1,STEP,947738756014,947741857987,3101973,-1
989,1,STEP,947741970986,947744933960,2962974,-1
990,1,STEP,947745036659,947747608936,2572277,-1
991,1,STEP,947747712636,947750758609,3045973,-1
992,1,STEP,947750852008,947753807882,2955874,-1
993,1,STEP,947753932581,947756911355,2978774,-1
994,1,STEP,947757019254,947759791630,2772376,-1
995,1,STEP,947759891229,947763450298,3559069,-1
996,1,STEP,947763552897,947766517971,2965074,-1
997,1,STEP,947766628370,947769770142,3141772,-1
998,1,STEP,947769884841,947772957115,3072274,-1
999,1,STEP,947773058114,947776197486,3139372,-1
