Gen,Resource,Stamp,TimeStamp_Start,TimeStamp_End,Duration,Indiv_id
0,1,FirstEvaluation,920673907906,921467066473,793158567,-1
0,1,STEP,921467247172,921473081016,5833844,-1
1,1,STEP,921473170215,921477658872,4488657,-1
2,1,STEP,921477744171,921482589024,4844853,-1
3,1,STEP,921482679023,921486898083,4219060,-1
4,1,STEP,921486982682,921490340049,3357367,-1
5,1,STEP,921490421849,921494934105,4512256,-1
6,1,STEP,921495017904,921499393362,4375458,-1
7,1,STEP,921499475362,921503608422,4133060,-1
8,1,STEP,921503691121,921507407285,3716164,-1
9,1,STEP,921507497084,921512386537,4889453,-1
10,1,STEP,921512465537,921516029702,3564165,-1
11,1,STEP,921516112101,921520872456,4760355,-1
12,1,STEP,921520949655,921525865208,4915553,-1
13,1,STEP,921525958207,921530164066,4205859,-1
14,1,STEP,921530243965,921534399425,4155460,-1
15,1,STEP,921534482525,921537693394,3210869,-1
16,1,STEP,921537775393,921541931353,4155960,-1
17,1,STEP,921542018552,921546130113,4111561,-1
18,1,STEP,921546212112,921549727978,3515866,-1
19,1,STEP,921549804677,921552883348,3078671,-1
20,1,STEP,921552962847,921557132807,4169960,-1
21,1,STEP,921557214306,921560736572,3522266,-1
22,1,STEP,921560822571,921563845142,3022571,-1
23,1,STEP,921563923041,921568019602,4096561,-1
24,1,STEP,921568105901,921572349160,4243259,-1
25,1,STEP,921572429060,921576363822,3934762,-1
26,1,STEP,921576484620,921580700380,4215760,-1
27,1,STEP,921580767979,921584933539,4165560,-1
28,1,STEP,921585004138,921588533005,3528867,-1
29,1,STEP,921588600704,921593329458,4728754,-1
30,1,STEP,921593401658,921597155222,3753564,-1
31,1,STEP,921597225821,921600954685,3728864,-1
32,1,STEP,921601034984,921604787448,3752464,-1
33,1,STEP,921604856947,921608125116,3268169,-1
34,1,STEP,921608194815,921611701182,3506367,-1
35,1,STEP,921611770381,921614953650,3183269,-1
36,1,STEP,921615024050,921618476916,3452866,-1
37,1,STEP,921618548016,921621581486,3033470,-1
38,1,STEP,921621651286,921624450959,2799673,-1
39,1,STEP,921624520758,921627566729,3045971,-1
40,1,STEP,921627636328,921630929397,3293069,-1
41,1,STEP,921630998396,921634297964,3299568,-1
42,1,STEP,921634367863,921638154227,3786364,-1
43,1,STEP,921638224526,921641273897,3049371,-1
44,1,STEP,921641342496,921644450966,3108470,-1
45,1,STEP,921644521466,921647944933,3423467,-1
46,1,STEP,921648016432,921651012003,2995571,-1
47,1,STEP,921651081503,921654077174,2995671,-1
48,1,STEP,921654148073,921657122644,2974571,-1
49,1,STEP,921657192644,921660022017,2829373,-1
50,1,STEP,921660093116,921663410984,3317868,-1
51,1,STEP,921663482983,921666811151,3328168,-1
52,1,STEP,921666883151,921670318917,3435766,-1
53,1,STEP,921670390417,921673579686,3189269,-1
54,1,STEP,921673650685,921677026153,3375468,-1
55,1,STEP,921677098252,921680846316,3748064,-1
56,1,STEP,921680918715,921684639980,3721265,-1
57,1,STEP,921684716679,921687835849,3119170,-1
58,1,STEP,921687909148,921690535123,2625975,-1
59,1,STEP,921690609022,921693206497,2597475,-1
60,1,STEP,921693278897,921696086569,2807672,-1
61,1,STEP,921696157669,921699439937,3282268,-1
62,1,STEP,921699513137,921702439708,2926571,-1
63,1,STEP,921702511508,921705702677,3191169,-1
64,1,STEP,921705774576,921709461241,3686665,-1
65,1,STEP,921709534240,921713205705,3671465,-1
66,1,STEP,921713277704,921715762880,2485176,-1
67,1,STEP,921715834879,921718913950,3079071,-1
68,1,STEP,921718986349,921721949521,2963172,-1
69,1,STEP,921722022720,921724760394,2737674,-1
70,1,STEP,921724831993,921727454168,2622175,-1
71,1,STEP,921727527167,921730564638,3037471,-1
72,1,STEP,921730638637,921733880806,3242169,-1
73,1,STEP,921733956305,921737393072,3436767,-1
74,1,STEP,921737465571,921740668440,3202869,-1
75,1,STEP,921740739940,921744879500,4139560,-1
76,1,STEP,921744951999,921747705573,2753574,-1
77,1,STEP,921747777072,921750707844,2930772,-1
78,1,STEP,921750780343,921753683715,2903372,-1
79,1,STEP,921753754015,921756535288,2781273,-1
80,1,STEP,921756607287,921759629458,3022171,-1
81,1,STEP,921759701757,921762446831,2745074,-1
82,1,STEP,921762518230,921765556601,3038371,-1
83,1,STEP,921765629200,921768526672,2897472,-1
84,1,STEP,921768599172,921771720242,3121070,-1
85,1,STEP,921771804541,921774719913,2915372,-1
86,1,STEP,921774792512,921777890382,3097870,-1
87,1,STEP,921777965582,921781015652,3050070,-1
88,1,STEP,921781087551,921784038123,2950572,-1
89,1,STEP,921784111922,921786932495,2820573,-1
90,1,STEP,921787005295,921790261763,3256468,-1
91,1,STEP,921790336762,921793830329,3493567,-1
92,1,STEP,921793933028,921797225596,3292568,-1
93,1,STEP,921797328395,921800055669,2727274,-1
94,1,STEP,921800138668,921802944441,2805773,-1
95,1,STEP,921803016240,921806207710,3191470,-1
96,1,STEP,921806280309,921809086982,2806673,-1
97,1,STEP,921809158781,921811957954,2799173,-1
98,1,STEP,921812029954,921814830327,2800373,-1
99,1,STEP,921814903826,921817946097,3042271,-1
100,1,STEP,921818018296,921820654471,2636175,-1
101,1,STEP,921820727070,921823576143,2849073,-1
102,1,STEP,921823649242,921826586014,2936772,-1
103,1,STEP,921826658913,921829301788,2642875,-1
104,1,STEP,921829370287,921832033461,2663174,-1
105,1,STEP,921832102961,921835365229,3262268,-1
106,1,STEP,921835448928,921838483799,3034871,-1
107,1,STEP,921838569898,921841414971,2845073,-1
108,1,STEP,921841500470,921844803538,3303068,-1
109,1,STEP,921844886738,921847924108,3037370,-1
110,1,STEP,921848008407,921851052278,3043871,-1
111,1,STEP,921851136877,921854151048,3014171,-1
112,1,STEP,921854236448,921857005121,2768673,-1
113,1,STEP,921857091420,921859767594,2676174,-1
114,1,STEP,921859849794,921862914964,3065170,-1
115,1,STEP,921862999363,921865706837,2707474,-1
116,1,STEP,921865791536,921868986406,3194870,-1
117,1,STEP,921869070405,921872173575,3103170,-1
118,1,STEP,921872255474,921875655141,3399667,-1
119,1,STEP,921875740041,921879143308,3403267,-1
120,1,STEP,921879240907,921882650874,3409967,-1
121,1,STEP,921882737973,921886008442,3270469,-1
122,1,STEP,921886097641,921889059312,2961671,-1
123,1,STEP,921889154312,921892071983,2917671,-1
124,1,STEP,921892159683,921895302152,3142469,-1
125,1,STEP,921895388852,921898125125,2736273,-1
126,1,STEP,921898218024,921901077897,2859873,-1
127,1,STEP,921901164096,921904812761,3648665,-1
128,1,STEP,921904970559,921908647124,3676565,-1
129,1,STEP,921908734623,921911686595,2951972,-1
130,1,STEP,921911767694,921914541067,2773373,-1
131,1,STEP,921914622966,921917514439,2891473,-1
132,1,STEP,921917593038,921920404211,2811173,-1
133,1,STEP,921920484310,921923325283,2840973,-1
134,1,STEP,921923407182,921926638051,3230869,-1
135,1,STEP,921926719550,921929724121,3004571,-1
136,1,STEP,921929803820,921932539794,2735974,-1
137,1,STEP,921932623393,921936150859,3527466,-1
138,1,STEP,921936235058,921939763225,3528167,-1
139,1,STEP,921939843524,921942840395,2996871,-1
140,1,STEP,921942925994,921946351861,3425867,-1
141,1,STEP,921946479960,921949748628,3268668,-1
142,1,STEP,921949881127,921953681991,3800864,-1
143,1,STEP,921953785990,921956902560,3116570,-1
144,1,STEP,921957017858,921959458635,2440777,-1
145,1,STEP,921959538934,921963682194,4143260,-1
146,1,STEP,921963808693,921967022862,3214169,-1
147,1,STEP,921967115461,921970436029,3320568,-1
148,1,STEP,921970565828,921974704088,4138260,-1
149,1,STEP,921974836187,921980221035,5384848,-1
150,1,STEP,921980330534,921983632302,3301768,-1
151,1,STEP,921983746401,921987339367,3592966,-1
152,1,STEP,921987430766,921990644235,3213469,-1
153,1,STEP,921990735934,921993430808,2694874,-1
154,1,STEP,921993522707,921996538478,3015771,-1
155,1,STEP,921996649577,921999873946,3224369,-1
156,1,STEP,921999963145,922002607320,2644175,-1
157,1,STEP,922002690019,922005812389,3122370,-1
158,1,STEP,922005935188,922009882650,3947462,-1
159,1,STEP,922009980849,922013269717,3288868,-1
160,1,STEP,922013366716,922016909582,3542866,-1
161,1,STEP,922017026381,922020303349,3276968,-1
162,1,STEP,922020422348,922023609318,3186970,-1
163,1,STEP,922023716217,922026602089,2885872,-1
164,1,STEP,922026709788,922029976956,3267168,-1
165,1,STEP,922030078455,922033189425,3110970,-1
166,1,STEP,922033288624,922036330495,3041871,-1
167,1,STEP,922036447494,922039533764,3086270,-1
168,1,STEP,922039636263,922042929532,3293269,-1
169,1,STEP,922043048431,922045970902,2922471,-1
170,1,STEP,922046084201,922049059373,2975172,-1
171,1,STEP,922049167172,922052263542,3096370,-1
172,1,STEP,922052367441,922055139214,2771773,-1
173,1,STEP,922055250713,922058458282,3207569,-1
174,1,STEP,922058574781,922061941849,3367068,-1
175,1,STEP,922062037548,922064873921,2836373,-1
176,1,STEP,922064975120,922068324987,3349867,-1
177,1,STEP,922068434586,922071638155,3203569,-1
178,1,STEP,922071743554,922074455228,2711674,-1
179,1,STEP,922074556027,922078052494,3496467,-1
180,1,STEP,922078144893,922080915466,2770573,-1
181,1,STEP,922081010765,922083795538,2784773,-1
182,1,STEP,922083903037,922086778010,2874973,-1
183,1,STEP,922086891609,922089861580,2969971,-1
184,1,STEP,922089963779,922093410546,3446767,-1
185,1,STEP,922093509445,922096852813,3343368,-1
186,1,STEP,922096964312,922099573987,2609675,-1
187,1,STEP,922099676486,922102759256,3082770,-1
188,1,STEP,922102852455,922105923025,3070570,-1
189,1,STEP,922106013825,922108675299,2661474,-1
190,1,STEP,922108770698,922111606471,2835773,-1
191,1,STEP,922111709170,922114804540,3095370,-1
192,1,STEP,922114895739,922117620713,2724974,-1
193,1,STEP,922117715012,922120675784,2960772,-1
194,1,STEP,922120780282,922123660055,2879773,-1
195,1,STEP,922123765554,922126747025,2981471,-1
196,1,STEP,922126838924,922130506289,3667365,-1
197,1,STEP,922130611688,922133449561,2837873,-1
198,1,STEP,922133555760,922136651730,3095970,-1
199,1,STEP,922136754129,922140010297,3256168,-1
200,1,STEP,922140112996,922143078768,2965772,-1
201,1,STEP,922143192367,922146214738,3022371,-1
202,1,STEP,922146318837,922149555306,3236469,-1
203,1,STEP,922149655405,922152555377,2899972,-1
204,1,STEP,922152663576,922156032543,3368967,-1
205,1,STEP,922156127542,922159231312,3103770,-1
206,1,STEP,922159324612,922163179974,3855362,-1
207,1,STEP,922163270174,922166393644,3123470,-1
208,1,STEP,922166504742,922169444314,2939572,-1
209,1,STEP,922169548813,922172761982,3213169,-1
210,1,STEP,922172869081,922175491756,2622675,-1
211,1,STEP,922175597455,922178838224,3240769,-1
212,1,STEP,922178948623,922182242291,3293668,-1
213,1,STEP,922182346890,922185956955,3610065,-1
214,1,STEP,922186055554,922189450122,3394568,-1
215,1,STEP,922189553521,922192433493,2879972,-1
216,1,STEP,922192548592,922196074858,3526266,-1
217,1,STEP,922196177457,922199293227,3115770,-1
218,1,STEP,922199386026,922202718394,3332368,-1
219,1,STEP,922202817193,922205751365,2934172,-1
220,1,STEP,922205859964,922209321830,3461866,-1
221,1,STEP,922209446429,922212520300,3073871,-1
222,1,STEP,922212623899,922216337863,3713964,-1
223,1,STEP,922216450262,922219965928,3515666,-1
224,1,STEP,922220056727,922223295596,3238869,-1
225,1,STEP,922223410895,922226619364,3208469,-1
226,1,STEP,922226723363,922229711734,2988371,-1
227,1,STEP,922229807733,922232908703,3100970,-1
228,1,STEP,922233009302,922235875975,2866673,-1
229,1,STEP,922235968874,922239132744,3163870,-1
230,1,STEP,922239242442,922242600910,3358468,-1
231,1,STEP,922242703609,922245809979,3106370,-1
232,1,STEP,922245931178,922248605852,2674674,-1
233,1,STEP,922248708251,922251903921,3195670,-1
234,1,STEP,922252021120,922254829292,2808172,-1
235,1,STEP,922254934291,922258850454,3916163,-1
236,1,STEP,922258969253,922261938024,2968771,-1
237,1,STEP,922262056623,922265606989,3550366,-1
238,1,STEP,922265707588,922268446561,2738973,-1
239,1,STEP,922268557360,922271745030,3187670,-1
240,1,STEP,922271878428,922275212696,3334268,-1
241,1,STEP,922275328395,922278526164,3197769,-1
242,1,STEP,922278652663,922281702034,3049371,-1
243,1,STEP,922281796933,922285340599,3543666,-1
244,1,STEP,922285477798,922289283561,3805763,-1
245,1,STEP,922289382760,922293320822,3938062,-1
246,1,STEP,922293413421,922295904197,2490776,-1
247,1,STEP,922295999196,922298734870,2735674,-1
248,1,STEP,922298854169,922301915539,3061370,-1
249,1,STEP,922302017938,922305183308,3165370,-1
250,1,STEP,922305287307,922309106770,3819463,-1
251,1,STEP,922309212669,922312381139,3168470,-1
252,1,STEP,922312477838,922315777306,3299468,-1
253,1,STEP,922315884605,922318608079,2723474,-1
254,1,STEP,922318698778,922321845848,3147070,-1
255,1,STEP,922321949947,922325076916,3126969,-1
256,1,STEP,922325228315,922328372285,3143970,-1
257,1,STEP,922328488284,922331869251,3380967,-1
258,1,STEP,922331985850,922334695424,2709574,-1
259,1,STEP,922334800223,922338079691,3279468,-1
260,1,STEP,922338211990,922341851055,3639065,-1
261,1,STEP,922341959754,922345035324,3075570,-1
262,1,STEP,922345138423,922348352192,3213769,-1
263,1,STEP,922348467491,922352553352,4085861,-1
264,1,STEP,922352630551,922355810721,3180170,-1
265,1,STEP,922355894520,922358504095,2609575,-1
266,1,STEP,922358578294,922361855863,3277569,-1
267,1,STEP,922361942262,922365331829,3389567,-1
268,1,STEP,922365407628,922367864105,2456477,-1
269,1,STEP,922367936604,922370994675,3058071,-1
270,1,STEP,922371070374,922374449941,3379567,-1
271,1,STEP,922374525641,922377830409,3304768,-1
272,1,STEP,922377915808,922381089477,3173669,-1
273,1,STEP,922381164577,922383604053,2439476,-1
274,1,STEP,922383708752,922386368627,2659875,-1
275,1,STEP,922386463526,922389852293,3388767,-1
276,1,STEP,922389991692,922393591357,3599665,-1
277,1,STEP,922393669356,922396490929,2821573,-1
278,1,STEP,922396561929,922399512200,2950271,-1
279,1,STEP,922399582599,922402567671,2985072,-1
280,1,STEP,922402640970,922405711140,3070170,-1
281,1,STEP,922405782540,922408297116,2514576,-1
282,1,STEP,922408366515,922411150988,2784473,-1
283,1,STEP,922411221287,922414303858,3082571,-1
284,1,STEP,922414379757,922417457327,3077570,-1
285,1,STEP,922417531327,922420650597,3119270,-1
286,1,STEP,922420723296,922423889966,3166670,-1
287,1,STEP,922423966365,922426832837,2866472,-1
288,1,STEP,922426904937,922429903808,2998871,-1
289,1,STEP,922429978607,922432525082,2546475,-1
290,1,STEP,922432630981,922435917250,3286269,-1
291,1,STEP,922436031349,922439071719,3040370,-1
292,1,STEP,922439154719,922442456587,3301868,-1
293,1,STEP,922442538886,922445590857,3051971,-1
294,1,STEP,922445668556,922448801926,3133370,-1
295,1,STEP,922448887225,922452330092,3442867,-1
296,1,STEP,922452415491,922455191164,2775673,-1
297,1,STEP,922455270564,922458230335,2959771,-1
298,1,STEP,922458316134,922461445204,3129070,-1
299,1,STEP,922461532203,922464382676,2850473,-1
300,1,STEP,922464467675,922467536946,3069271,-1
301,1,STEP,922467612045,922470120221,2508176,-1
302,1,STEP,922470206020,922473120992,2914972,-1
303,1,STEP,922473207291,922476193962,2986671,-1
304,1,STEP,922476271461,922479371532,3100071,-1
305,1,STEP,922479447031,922482535201,3088170,-1
306,1,STEP,922482616000,922486002768,3386768,-1
307,1,STEP,922486080767,922488801841,2721074,-1
308,1,STEP,922488877140,922491897311,3020171,-1
309,1,STEP,922491985810,922494511486,2525676,-1
310,1,STEP,922494590685,922498036352,3445667,-1
311,1,STEP,922498118251,922501322020,3203769,-1
312,1,STEP,922501411520,922504560989,3149469,-1
313,1,STEP,922504671988,922507911157,3239169,-1
314,1,STEP,922508036356,922511006427,2970071,-1
315,1,STEP,922511124726,922514198496,3073770,-1
316,1,STEP,922514321795,922517204968,2883173,-1
317,1,STEP,922517324766,922520169539,2844773,-1
318,1,STEP,922520301038,922523476007,3174969,-1
319,1,STEP,922523593006,922526914774,3321768,-1
320,1,STEP,922527039773,922530150043,3110270,-1
321,1,STEP,922530269842,922533658509,3388667,-1
322,1,STEP,922533780908,922536903378,3122470,-1
323,1,STEP,922537031577,922540559643,3528066,-1
324,1,STEP,922540675442,922543476315,2800873,-1
325,1,STEP,922543566514,922546854182,3287668,-1
326,1,STEP,922546962481,922550437348,3474867,-1
327,1,STEP,922550552647,922553510118,2957471,-1
328,1,STEP,922553614017,922556296491,2682474,-1
329,1,STEP,922556408290,922559466861,3058571,-1
330,1,STEP,922559584160,922562771929,3187769,-1
331,1,STEP,922562879528,922565968298,3088770,-1
332,1,STEP,922566068897,922568580573,2511676,-1
333,1,STEP,922568687572,922571923141,3235569,-1
334,1,STEP,922572037340,922575091110,3053770,-1
335,1,STEP,922575209009,922577984383,2775374,-1
336,1,STEP,922578100382,922581167652,3067270,-1
337,1,STEP,922581281551,922584276322,2994771,-1
338,1,STEP,922584392621,922587560990,3168369,-1
339,1,STEP,922587675689,922590580461,2904772,-1
340,1,STEP,922590706260,922594044428,3338168,-1
341,1,STEP,922594161927,922597425396,3263469,-1
342,1,STEP,922597561294,922601565156,4003862,-1
343,1,STEP,922601704354,922606342110,4637756,-1
344,1,STEP,922606422809,922609541079,3118270,-1
345,1,STEP,922609613678,922612404451,2790773,-1
346,1,STEP,922612475351,922615375823,2900472,-1
347,1,STEP,922615446822,922618415094,2968272,-1
348,1,STEP,922618486393,922621793761,3307368,-1
349,1,STEP,922621866460,922625115429,3248969,-1
350,1,STEP,922625192228,922628787794,3595566,-1
351,1,STEP,922628879393,922632327160,3447767,-1
352,1,STEP,922632428859,922635671128,3242269,-1
353,1,STEP,922635762927,922638687698,2924771,-1
354,1,STEP,922638782898,922641851268,3068370,-1
355,1,STEP,922641957267,922645568932,3611665,-1
356,1,STEP,922645660631,922648776001,3115370,-1
357,1,STEP,922648870200,922651952871,3082671,-1
358,1,STEP,922652048070,922654930442,2882372,-1
359,1,STEP,922655025541,922658144011,3118470,-1
360,1,STEP,922658236710,922661709077,3472367,-1
361,1,STEP,922661803476,922664802347,2998871,-1
362,1,STEP,922664901346,922667608120,2706774,-1
363,1,STEP,922667699719,922670266295,2566576,-1
364,1,STEP,922670364394,922673388565,3024171,-1
365,1,STEP,922673485664,922676673033,3187369,-1
366,1,STEP,922676774032,922680139100,3365068,-1
367,1,STEP,922680233699,922683224470,2990771,-1
368,1,STEP,922683319569,922686222041,2902472,-1
369,1,STEP,922686315740,922689537909,3222169,-1
370,1,STEP,922689634108,922692317882,2683774,-1
371,1,STEP,922692413881,922695621351,3207470,-1
372,1,STEP,922695707550,922698964318,3256768,-1
373,1,STEP,922699055018,922701922990,2867972,-1
374,1,STEP,922702019489,922704922961,2903472,-1
375,1,STEP,922705021660,922707882433,2860773,-1
376,1,STEP,922707983432,922710765005,2781573,-1
377,1,STEP,922710861504,922713796976,2935472,-1
378,1,STEP,922713911775,922716648848,2737073,-1
379,1,STEP,922716735447,922719673319,2937872,-1
380,1,STEP,922719763018,922722892988,3129970,-1
381,1,STEP,922722995287,922725589462,2594175,-1
382,1,STEP,922725684161,922728976630,3292469,-1
383,1,STEP,922729073829,922732026500,2952671,-1
384,1,STEP,922732127299,922735290669,3163370,-1
385,1,STEP,922735386668,922738364139,2977471,-1
386,1,STEP,922738452738,922741663907,3211169,-1
387,1,STEP,922741763407,922744823677,3060270,-1
388,1,STEP,922744918876,922748074146,3155270,-1
389,1,STEP,922748172245,922751206216,3033971,-1
390,1,STEP,922751307715,922754489084,3181369,-1
391,1,STEP,922754583883,922757617654,3033771,-1
392,1,STEP,922757713853,922760961322,3247469,-1
393,1,STEP,922761058421,922764211591,3153170,-1
394,1,STEP,922764305690,922767428660,3122970,-1
395,1,STEP,922767526659,922770965326,3438667,-1
396,1,STEP,922771063625,922774171395,3107770,-1
397,1,STEP,922774272994,922777072467,2799473,-1
398,1,STEP,922777158166,922780243936,3085770,-1
399,1,STEP,922780345735,922783903501,3557766,-1
400,1,STEP,922783994100,922787048471,3054371,-1
401,1,STEP,922787138970,922789951443,2812473,-1
402,1,STEP,922790048942,922792483818,2434876,-1
403,1,STEP,922792579318,922795709787,3130469,-1
404,1,STEP,922795799887,922798448961,2649074,-1
405,1,STEP,922798549160,922801486232,2937072,-1
406,1,STEP,922801582931,922804400704,2817773,-1
407,1,STEP,922804496503,922807744672,3248169,-1
408,1,STEP,922807840771,922811164839,3324068,-1
409,1,STEP,922811257838,922814668305,3410467,-1
410,1,STEP,922814766804,922817678976,2912172,-1
411,1,STEP,922817775875,922821183942,3408067,-1
412,1,STEP,922821278441,922824164914,2886473,-1
413,1,STEP,922824265513,922827802279,3536766,-1
414,1,STEP,922827897578,922830858249,2960671,-1
415,1,STEP,922830960648,922833411725,2451077,-1
416,1,STEP,922833495024,922836672593,3177569,-1
417,1,STEP,922836767992,922839462466,2694474,-1
418,1,STEP,922839560965,922842643036,3082071,-1
419,1,STEP,922842741435,922845788205,3046770,-1
420,1,STEP,922845898404,922848661878,2763474,-1
421,1,STEP,922848764377,922851620949,2856572,-1
422,1,STEP,922851718048,922855101416,3383368,-1
423,1,STEP,922855199415,922858345585,3146170,-1
424,1,STEP,922858443084,922861226357,2783273,-1
425,1,STEP,922861325156,922864356127,3030971,-1
426,1,STEP,922864444626,922867770094,3325468,-1
427,1,STEP,922867871993,922870464968,2592975,-1
428,1,STEP,922870558167,922874139533,3581366,-1
429,1,STEP,922874240632,922877367202,3126570,-1
430,1,STEP,922877457701,922880310373,2852672,-1
431,1,STEP,922880405372,922883505642,3100270,-1
432,1,STEP,922883594942,922886460414,2865472,-1
433,1,STEP,922886552513,922890082979,3530466,-1
434,1,STEP,922890177778,922892892352,2714574,-1
435,1,STEP,922892982251,922896343819,3361568,-1
436,1,STEP,922896442418,922899318790,2876372,-1
437,1,STEP,922899414489,922902573959,3159470,-1
438,1,STEP,922902669858,922906186524,3516666,-1
439,1,STEP,922906277023,922909474893,3197870,-1
440,1,STEP,922909563092,922912565263,3002171,-1
441,1,STEP,922912661762,922915285537,2623775,-1
442,1,STEP,922915383936,922918633104,3249168,-1
443,1,STEP,922918719404,922922470968,3751564,-1
444,1,STEP,922922565967,922925846435,3280468,-1
445,1,STEP,922925939234,922928517309,2578075,-1
446,1,STEP,922928610608,922932012776,3402168,-1
447,1,STEP,922932104475,922934930648,2826173,-1
448,1,STEP,922935024947,922937935319,2910372,-1
449,1,STEP,922938023818,922940876990,2853172,-1
450,1,STEP,922940971889,922943785762,2813873,-1
451,1,STEP,922943878062,922946936132,3058070,-1
452,1,STEP,922947033331,922950214801,3181470,-1
453,1,STEP,922950305800,922953369070,3063270,-1
454,1,STEP,922953456069,922956549540,3093471,-1
455,1,STEP,922956639739,922959826608,3186869,-1
456,1,STEP,922959919207,922962966978,3047771,-1
457,1,STEP,922963062477,922966087748,3025271,-1
458,1,STEP,922966178847,922969216218,3037371,-1
459,1,STEP,922969303617,922972589285,3285668,-1
460,1,STEP,922972683584,922975780354,3096770,-1
461,1,STEP,922975875154,922978988924,3113770,-1
462,1,STEP,922979081323,922982118793,3037470,-1
463,1,STEP,922982219593,922985505361,3285768,-1
464,1,STEP,922985597660,922989030227,3432567,-1
465,1,STEP,922989128826,922993722982,4594156,-1
466,1,STEP,922993820781,922997386147,3565366,-1
467,1,STEP,922997487146,923000810814,3323668,-1
468,1,STEP,923000911913,923004646677,3734764,-1
469,1,STEP,923004778375,923008875536,4097161,-1
470,1,STEP,923008956335,923012532101,3575766,-1
471,1,STEP,923012607900,923015554572,2946672,-1
472,1,STEP,923015627671,923019875830,4248159,-1
473,1,STEP,923019963929,923023481195,3517266,-1
474,1,STEP,923023561095,923027247059,3685964,-1
475,1,STEP,923027323658,923030134431,2810773,-1
476,1,STEP,923030207531,923033209402,3001871,-1
477,1,STEP,923033282501,923036483970,3201469,-1
478,1,STEP,923036558170,923040094736,3536566,-1
479,1,STEP,923040169735,923043235305,3065570,-1
480,1,STEP,923043311005,923046225877,2914872,-1
481,1,STEP,923046300076,923049344247,3044171,-1
482,1,STEP,923049416546,923051905022,2488476,-1
483,1,STEP,923051976521,923054907293,2930772,-1
484,1,STEP,923054979592,923057865765,2886173,-1
485,1,STEP,923057946864,923061382931,3436067,-1
486,1,STEP,923061456930,923064227103,2770173,-1
487,1,STEP,923064299403,923067134675,2835272,-1
488,1,STEP,923067206475,923071399534,4193059,-1
489,1,STEP,923071475634,923074708802,3233168,-1
490,1,STEP,923074782402,923077657574,2875172,-1
491,1,STEP,923077728673,923080435347,2706674,-1
492,1,STEP,923080507447,923083919514,3412067,-1
493,1,STEP,923084017113,923086642488,2625375,-1
494,1,STEP,923086741087,923089504960,2763873,-1
495,1,STEP,923089597059,923092304233,2707174,-1
496,1,STEP,923092402032,923095299304,2897272,-1
497,1,STEP,923095391103,923098374575,2983472,-1
498,1,STEP,923098466974,923102302337,3835363,-1
499,1,STEP,923102399836,923105552106,3152270,-1
500,1,STEP,923105647505,923108950573,3303068,-1
501,1,STEP,923109044772,923111783646,2738874,-1
502,1,STEP,923111876545,923114914316,3037771,-1
503,1,STEP,923115006515,923118308783,3302268,-1
504,1,STEP,923118403582,923121501252,3097670,-1
505,1,STEP,923121605551,923124642222,3036671,-1
506,1,STEP,923124763021,923127611993,2848972,-1
507,1,STEP,923127726392,923130859362,3132970,-1
508,1,STEP,923130965761,923134130731,3164970,-1
509,1,STEP,923134248329,923137556898,3308569,-1
510,1,STEP,923137668397,923140709867,3041470,-1
511,1,STEP,923140822366,923143953436,3131070,-1
512,1,STEP,923144125634,923147182105,3056471,-1
513,1,STEP,923147294404,923150106177,2811773,-1
514,1,STEP,923150231376,923153316046,3084670,-1
515,1,STEP,923153435545,923156305917,2870372,-1
516,1,STEP,923156420416,923159740384,3319968,-1
517,1,STEP,923159856583,923162925154,3068571,-1
518,1,STEP,923163041352,923166486819,3445467,-1
519,1,STEP,923166600018,923169794587,3194569,-1
520,1,STEP,923169905986,923173394353,3488367,-1
521,1,STEP,923173505152,923176879419,3374267,-1
522,1,STEP,923176987718,923180385485,3397767,-1
523,1,STEP,923180496984,923183860252,3363268,-1
524,1,STEP,923183969951,923187310319,3340368,-1
525,1,STEP,923187430118,923191273481,3843363,-1
526,1,STEP,923191365480,923194697248,3331768,-1
527,1,STEP,923194785347,923197631920,2846573,-1
528,1,STEP,923197715319,923200750990,3035671,-1
529,1,STEP,923200841689,923204153957,3312268,-1
530,1,STEP,923204237956,923207418325,3180369,-1
531,1,STEP,923207503925,923210819093,3315168,-1
532,1,STEP,923210912892,923213641865,2728973,-1
533,1,STEP,923213725465,923216914934,3189469,-1
534,1,STEP,923217000333,923219751907,2751574,-1
535,1,STEP,923219840406,923223026275,3185869,-1
536,1,STEP,923223113274,923226065946,2952672,-1
537,1,STEP,923226153145,923228837119,2683974,-1
538,1,STEP,923228924318,923232774281,3849963,-1
539,1,STEP,923232895980,923235571354,2675374,-1
540,1,STEP,923235659454,923238593825,2934371,-1
541,1,STEP,923238690624,923242057392,3366768,-1
542,1,STEP,923242158191,923244424669,2266478,-1
543,1,STEP,923244515668,923247592339,3076671,-1
544,1,STEP,923247676538,923250600010,2923472,-1
545,1,STEP,923250684209,923254127176,3442967,-1
546,1,STEP,923254213875,923257108447,2894572,-1
547,1,STEP,923257197546,923260840511,3642965,-1
548,1,STEP,923260930910,923264632975,3702065,-1
549,1,STEP,923264737674,923267942243,3204569,-1
550,1,STEP,923268031242,923271313210,3281968,-1
551,1,STEP,923271404910,923274505880,3100970,-1
552,1,STEP,923274593279,923277565050,2971771,-1
553,1,STEP,923277651349,923280892018,3240669,-1
554,1,STEP,923280979917,923284617882,3637965,-1
555,1,STEP,923284705482,923288179448,3473966,-1
556,1,STEP,923288272547,923291244919,2972372,-1
557,1,STEP,923291338218,923294081291,2743073,-1
558,1,STEP,923294168991,923297745456,3576465,-1
559,1,STEP,923297841655,923300646028,2804373,-1
560,1,STEP,923300732627,923303336402,2603775,-1
561,1,STEP,923303423301,923305953677,2530376,-1
562,1,STEP,923306040676,923308654451,2613775,-1
563,1,STEP,923308735550,923311923520,3187970,-1
564,1,STEP,923312013319,923315575085,3561766,-1
565,1,STEP,923315659784,923318709254,3049470,-1
566,1,STEP,923318797154,923321703126,2905972,-1
567,1,STEP,923321786725,923324983694,3196969,-1
568,1,STEP,923325070793,923327873366,2802573,-1
569,1,STEP,923327960165,923331026836,3066671,-1
570,1,STEP,923331114435,923335024397,3909962,-1
571,1,STEP,923335120896,923338615863,3494967,-1
572,1,STEP,923338710962,923341683533,2972571,-1
573,1,STEP,923341771232,923345861993,4090761,-1
574,1,STEP,923345972392,923349157761,3185369,-1
575,1,STEP,923349243961,923352464930,3220969,-1
576,1,STEP,923352554129,923355483200,2929071,-1
577,1,STEP,923355572200,923358698270,3126070,-1
578,1,STEP,923358788569,923361983238,3194669,-1
579,1,STEP,923362075237,923365227607,3152370,-1
580,1,STEP,923365314206,923368306377,2992171,-1
581,1,STEP,923368392876,923371173149,2780273,-1
582,1,STEP,923371263149,923374644016,3380867,-1
583,1,STEP,923374734215,923377494589,2760374,-1
584,1,STEP,923377581488,923380609559,3028071,-1
585,1,STEP,923380695258,923383794228,3098970,-1
586,1,STEP,923383883827,923387295594,3411767,-1
587,1,STEP,923387387293,923390691162,3303869,-1
588,1,STEP,923390787561,923394319627,3532066,-1
589,1,STEP,923394407626,923397413697,3006071,-1
590,1,STEP,923397497896,923400833464,3335568,-1
591,1,STEP,923400927363,923404250631,3323268,-1
592,1,STEP,923404342630,923408132094,3789464,-1
593,1,STEP,923408219493,923411308963,3089470,-1
594,1,STEP,923411398562,923414128236,2729674,-1
595,1,STEP,923414224235,923417190207,2965972,-1
596,1,STEP,923417275606,923420053779,2778173,-1
597,1,STEP,923420143178,923423096450,2953272,-1
598,1,STEP,923423190849,923426081621,2890772,-1
599,1,STEP,923426168420,923429639187,3470767,-1
600,1,STEP,923429726486,923433025254,3298768,-1
601,1,STEP,923433114253,923436479721,3365468,-1
602,1,STEP,923436571220,923439675790,3104570,-1
603,1,STEP,923439764989,923442979958,3214969,-1
604,1,STEP,923443066358,923445979930,2913572,-1
605,1,STEP,923446071629,923450668584,4596955,-1
606,1,STEP,923450754584,923453749255,2994671,-1
607,1,STEP,923453833954,923457028523,3194569,-1
608,1,STEP,923457112622,923460229792,3117170,-1
609,1,STEP,923460315892,923463461061,3145169,-1
610,1,STEP,923463547461,923466733430,3185969,-1
611,1,STEP,923466823029,923469542503,2719474,-1
612,1,STEP,923469627002,923472578174,2951172,-1
613,1,STEP,923472663073,923475728843,3065770,-1
614,1,STEP,923475818542,923479095111,3276569,-1
615,1,STEP,923479180510,923482103782,2923272,-1
616,1,STEP,923482189281,923484940555,2751274,-1
617,1,STEP,923485022354,923487526730,2504376,-1
618,1,STEP,923487611629,923490642200,3030571,-1
619,1,STEP,923490724999,923493819169,3094170,-1
620,1,STEP,923493909968,923496943039,3033071,-1
621,1,STEP,923497029138,923499769112,2739974,-1
622,1,STEP,923499852011,923502639484,2787473,-1
623,1,STEP,923502728883,923505837754,3108871,-1
624,1,STEP,923505943053,923509221221,3278168,-1
625,1,STEP,923509320920,923513090684,3769764,-1
626,1,STEP,923513180383,923516295053,3114670,-1
627,1,STEP,923516376352,923519690320,3313968,-1
628,1,STEP,923519777119,923523066488,3289369,-1
629,1,STEP,923523152087,923526165258,3013171,-1
630,1,STEP,923526259057,923529849922,3590865,-1
631,1,STEP,923529951221,923532864693,2913472,-1
632,1,STEP,923532949193,923536001663,3052470,-1
633,1,STEP,923536087362,923539239832,3152470,-1
634,1,STEP,923539357631,923542397902,3040271,-1
635,1,STEP,923542483901,923545428773,2944872,-1
636,1,STEP,923545515172,923548066847,2551675,-1
637,1,STEP,923548152546,923551677012,3524466,-1
638,1,STEP,923551764312,923555042080,3277768,-1
639,1,STEP,923555128679,923557909652,2780973,-1
640,1,STEP,923557999352,923560963323,2963971,-1
641,1,STEP,923561051022,923564185192,3134170,-1
642,1,STEP,923564271491,923567260762,2989271,-1
643,1,STEP,923567349162,923570326933,2977771,-1
644,1,STEP,923570412832,923573692101,3279269,-1
645,1,STEP,923573778500,923576906370,3127870,-1
646,1,STEP,923576989369,923580109239,3119870,-1
647,1,STEP,923580195938,923583678204,3482266,-1
648,1,STEP,923583765904,923586865774,3099870,-1
649,1,STEP,923586951573,923590710937,3759364,-1
650,1,STEP,923590795736,923593788507,2992771,-1
651,1,STEP,923593887006,923596652380,2765374,-1
652,1,STEP,923596743079,923600045147,3302068,-1
653,1,STEP,923600129946,923602912419,2782473,-1
654,1,STEP,923602997519,923606284487,3286968,-1
655,1,STEP,923606371786,923609806953,3435167,-1
656,1,STEP,923609906052,923613034122,3128070,-1
657,1,STEP,923613121521,923616212591,3091070,-1
658,1,STEP,923616301791,923618998165,2696374,-1
659,1,STEP,923619084764,923622473431,3388667,-1
660,1,STEP,923622558530,923626020097,3461567,-1
661,1,STEP,923626139396,923629552263,3412867,-1
662,1,STEP,923629627762,923632728132,3100370,-1
663,1,STEP,923632802032,923636100900,3298868,-1
664,1,STEP,923636176699,923639260770,3084071,-1
665,1,STEP,923639335269,923642911034,3575765,-1
666,1,STEP,923642983534,923646072204,3088670,-1
667,1,STEP,923646148003,923649190174,3042171,-1
668,1,STEP,923649263673,923652173245,2909572,-1
669,1,STEP,923652247245,923654910419,2663174,-1
670,1,STEP,923654993318,923658866881,3873563,-1
671,1,STEP,923658944480,923662352347,3407867,-1
672,1,STEP,923662434747,923665739715,3304968,-1
673,1,STEP,923665811814,923668855485,3043671,-1
674,1,STEP,923668951284,923672209252,3257968,-1
675,1,STEP,923672295352,923675641619,3346267,-1
676,1,STEP,923675719619,923678667090,2947471,-1
677,1,STEP,923678741990,923682042558,3300568,-1
678,1,STEP,923682123657,923684716832,2593175,-1
679,1,STEP,923684795531,923688071600,3276069,-1
680,1,STEP,923688148699,923691702065,3553366,-1
681,1,STEP,923691778764,923695079432,3300668,-1
682,1,STEP,923695164032,923698698898,3534866,-1
683,1,STEP,923698793497,923702108965,3315468,-1
684,1,STEP,923702194364,923705287234,3092870,-1
685,1,STEP,923705369833,923708877600,3507767,-1
686,1,STEP,923708962099,923712082069,3119970,-1
687,1,STEP,923712159068,923715781233,3622165,-1
688,1,STEP,923715859832,923718871803,3011971,-1
689,1,STEP,923718960203,923722300270,3340067,-1
690,1,STEP,923722388470,923725467440,3078970,-1
691,1,STEP,923725542139,923728756608,3214469,-1
692,1,STEP,923728835608,923732841169,4005561,-1
693,1,STEP,923732922468,923735638042,2715574,-1
694,1,STEP,923735713541,923738710513,2996972,-1
695,1,STEP,923738787712,923741710884,2923172,-1
696,1,STEP,923741783883,923744491857,2707974,-1
697,1,STEP,923744566456,923747507228,2940772,-1
698,1,STEP,923747591127,923750765297,3174170,-1
699,1,STEP,923750840596,923754042565,3201969,-1
700,1,STEP,923754116064,923757287234,3171170,-1
701,1,STEP,923757360633,923760397504,3036871,-1
702,1,STEP,923760470003,923763796171,3326168,-1
703,1,STEP,923763870670,923766572944,2702274,-1
704,1,STEP,923766646144,923769690014,3043870,-1
705,1,STEP,923769763314,923772363189,2599875,-1
706,1,STEP,923772435788,923774992063,2556275,-1
707,1,STEP,923775065263,923778015834,2950571,-1
708,1,STEP,923778089134,923781162604,3073470,-1
709,1,STEP,923781236403,923784413473,3177070,-1
710,1,STEP,923784485272,923787737041,3251769,-1
711,1,STEP,923787811140,923790504914,2693774,-1
712,1,STEP,923790577013,923793601284,3024271,-1
713,1,STEP,923793674184,923797419548,3745364,-1
714,1,STEP,923797494347,923800442018,2947671,-1
715,1,STEP,923800514318,923803688687,3174369,-1
716,1,STEP,923803763286,923806839757,3076471,-1
717,1,STEP,923806914556,923809657230,2742674,-1
718,1,STEP,923809730229,923812500702,2770473,-1
719,1,STEP,923812574302,923815604373,3030071,-1
720,1,STEP,923815676472,923818966540,3290068,-1
721,1,STEP,923819039139,923821877012,2837873,-1
722,1,STEP,923821950711,923825457478,3506767,-1
723,1,STEP,923825530277,923828491249,2960972,-1
724,1,STEP,923828564948,923831987115,3422167,-1
725,1,STEP,923832061214,923835355882,3294668,-1
726,1,STEP,923835429082,923838446853,3017771,-1
727,1,STEP,923838520452,923841640422,3119970,-1
728,1,STEP,923841713321,923844722192,3008871,-1
729,1,STEP,923844794992,923848222259,3427267,-1
730,1,STEP,923848296158,923851962923,3666765,-1
731,1,STEP,923852038122,923855214591,3176469,-1
732,1,STEP,923855288091,923857991265,2703174,-1
733,1,STEP,923858064664,923860906337,2841673,-1
734,1,STEP,923860978636,923863539411,2560775,-1
735,1,STEP,923863611711,923866273985,2662274,-1
736,1,STEP,923866346384,923869331255,2984871,-1
737,1,STEP,923869403155,923872083429,2680274,-1
738,1,STEP,923872154728,923874990101,2835373,-1
739,1,STEP,923875064200,923878150871,3086671,-1
740,1,STEP,923878226270,923880955344,2729074,-1
741,1,STEP,923881026643,923883813616,2786973,-1
742,1,STEP,923883888015,923887087385,3199370,-1
743,1,STEP,923887161084,923890800949,3639865,-1
744,1,STEP,923890876748,923893840820,2964072,-1
745,1,STEP,923893931019,923897274787,3343768,-1
746,1,STEP,923897349586,923900444856,3095270,-1
747,1,STEP,923900518655,923903073031,2554376,-1
748,1,STEP,923903146230,923906307900,3161670,-1
749,1,STEP,923906384099,923908786376,2402277,-1
750,1,STEP,923908856675,923912004845,3148170,-1
751,1,STEP,923912078644,923915270013,3191369,-1
752,1,STEP,923915343613,923918313284,2969671,-1
753,1,STEP,923918385583,923920909059,2523476,-1
754,1,STEP,923920981058,923924255827,3274769,-1
755,1,STEP,923924330426,923926938001,2607575,-1
756,1,STEP,923927009400,923930068371,3058971,-1
757,1,STEP,923930143470,923932945843,2802373,-1
758,1,STEP,923933020443,923936457613,3437170,-1
759,1,STEP,923936534812,923939790687,3255875,-1
760,1,STEP,923939864587,923942498366,2633779,-1
761,1,STEP,923942591266,923945925240,3333974,-1
762,1,STEP,923946016740,923948993617,2976877,-1
763,1,STEP,923949082316,923951948694,2866378,-1
764,1,STEP,923952039093,923954828472,2789379,-1
765,1,STEP,923954915871,923957721950,2806079,-1
766,1,STEP,923957810249,923960956325,3146076,-1
767,1,STEP,923961051725,923965245192,4193467,-1
768,1,STEP,923965376191,923968229470,2853279,-1
769,1,STEP,923968319569,923970702151,2382582,-1
770,1,STEP,923970789050,923974091625,3302575,-1
771,1,STEP,923974193924,923977212501,3018577,-1
772,1,STEP,923977308000,923980217578,2909578,-1
773,1,STEP,923980304377,923983897950,3593573,-1
774,1,STEP,923983987049,923986862327,2875278,-1
775,1,STEP,923986959026,923990028403,3069377,-1
776,1,STEP,923990116802,923993475876,3359074,-1
777,1,STEP,923993564076,923996435854,2871778,-1
778,1,STEP,923996521853,923999546130,3024277,-1
779,1,STEP,923999631929,924002859705,3227776,-1
780,1,STEP,924002949404,924005568184,2618780,-1
781,1,STEP,924005651483,924008033265,2381782,-1
782,1,STEP,924008118364,924011221241,3102877,-1
783,1,STEP,924011306740,924014211918,2905178,-1
784,1,STEP,924014312317,924017050596,2738279,-1
785,1,STEP,924017133195,924020269371,3136176,-1
786,1,STEP,924020366171,924023436547,3070376,-1
787,1,STEP,924023519847,924026152226,2632379,-1
788,1,STEP,924026249826,924029544001,3294175,-1
789,1,STEP,924029647900,924032803876,3155976,-1
790,1,STEP,924032900775,924036493147,3592372,-1
791,1,STEP,924036613846,924040471017,3857171,-1
792,1,STEP,924040572316,924044466986,3894670,-1
793,1,STEP,924044611485,924049789546,5178061,-1
794,1,STEP,924049936345,924055001806,5065461,-1
795,1,STEP,924055133805,924059846069,4712264,-1
796,1,STEP,924059978868,924063940037,3961169,-1
797,1,STEP,924064067036,924066806715,2739679,-1
798,1,STEP,924066928215,924072281774,5353559,-1
799,1,STEP,924072422673,924077265935,4843262,-1
800,1,STEP,924077405734,924081657602,4251868,-1
801,1,STEP,924081802701,924086971261,5168560,-1
802,1,STEP,924087117760,924090927031,3809271,-1
803,1,STEP,924091073030,924096670087,5597057,-1
804,1,STEP,924096817886,924102233144,5415258,-1
805,1,STEP,924102368343,924106410012,4041669,-1
806,1,STEP,924106728310,924111659372,4931062,-1
807,1,STEP,924111909470,924116624234,4714764,-1
808,1,STEP,924117073431,924121391198,4317767,-1
809,1,STEP,924121825295,924126333060,4507765,-1
810,1,STEP,924126636458,924130684627,4048169,-1
811,1,STEP,924131259522,924136389883,5130361,-1
812,1,STEP,924136816280,924142329538,5513258,-1
813,1,STEP,924142749534,924147198800,4449266,-1
814,1,STEP,924147362099,924150774973,3412874,-1
815,1,STEP,924150877172,924155357138,4479966,-1
816,1,STEP,924155457937,924159202609,3744672,-1
817,1,STEP,924159301508,924162681482,3379974,-1
818,1,STEP,924162778281,924165883658,3105377,-1
819,1,STEP,924165980057,924169025533,3045476,-1
820,1,STEP,924169115133,924171881712,2766579,-1
821,1,STEP,924171973611,924175012088,3038477,-1
822,1,STEP,924175105587,924177850066,2744479,-1
823,1,STEP,924177954165,924181110941,3156776,-1
824,1,STEP,924181205540,924184756413,3550873,-1
825,1,STEP,924184890712,924189358078,4467366,-1
826,1,STEP,924189497577,924193545046,4047469,-1
827,1,STEP,924193647245,924197043119,3395874,-1
828,1,STEP,924197150918,924201060788,3909870,-1
829,1,STEP,924201200287,924205837952,4637665,-1
830,1,STEP,924206177849,924209472324,3294475,-1
831,1,STEP,924209595923,924213108796,3512873,-1
832,1,STEP,924213231795,924216604169,3372374,-1
833,1,STEP,924216728169,924219604747,2876578,-1
834,1,STEP,924219726346,924223093420,3367074,-1
835,1,STEP,924223210519,924226350695,3140176,-1
836,1,STEP,924226469194,924230176166,3706972,-1
837,1,STEP,924230293165,924233427741,3134576,-1
838,1,STEP,924233544040,924236566317,3022277,-1
839,1,STEP,924236689516,924239538394,2848878,-1
840,1,STEP,924239663493,924242787469,3123976,-1
841,1,STEP,924242906668,924246039944,3133276,-1
842,1,STEP,924246159243,924250281212,4121969,-1
843,1,STEP,924250402411,924253953784,3551373,-1
844,1,STEP,924254076183,924257549156,3472973,-1
845,1,STEP,924257671255,924261156729,3485474,-1
846,1,STEP,924261275928,924264944800,3668872,-1
847,1,STEP,924265068499,924268609172,3540673,-1
848,1,STEP,924268729971,924272260444,3530473,-1
849,1,STEP,924272381443,924276177014,3795571,-1
850,1,STEP,924276303013,924279336390,3033377,-1
851,1,STEP,924279456189,924282950562,3494373,-1
852,1,STEP,924283073561,924287151030,4077469,-1
853,1,STEP,924287279429,924290737102,3457673,-1
854,1,STEP,924290870501,924293911378,3040877,-1
855,1,STEP,924294035877,924297153153,3117276,-1
856,1,STEP,924297273852,924300412828,3138976,-1
857,1,STEP,924300539027,924303760803,3221776,-1
858,1,STEP,924303898402,924307457674,3559272,-1
859,1,STEP,924307548174,924310938648,3390474,-1
860,1,STEP,924311035247,924314360722,3325475,-1
861,1,STEP,924314460521,924317699596,3239075,-1
862,1,STEP,924317797195,924321333768,3536573,-1
863,1,STEP,924321446967,924324932341,3485374,-1
864,1,STEP,924325065840,924328470814,3404974,-1
865,1,STEP,924328561313,924331768988,3207675,-1
866,1,STEP,924331857388,924334742766,2885378,-1
867,1,STEP,924334833365,924338029641,3196276,-1
868,1,STEP,924338148240,924341450114,3301874,-1
869,1,STEP,924341549614,924346878873,5329259,-1
870,1,STEP,924347015472,924350774943,3759471,-1
871,1,STEP,924350866942,924353686221,2819279,-1
872,1,STEP,924353810520,924357120095,3309575,-1
873,1,STEP,924357251694,924360394169,3142475,-1
874,1,STEP,924360513469,924363503346,2989877,-1
875,1,STEP,924363590545,924366828720,3238175,-1
876,1,STEP,924366920520,924370065595,3145075,-1
877,1,STEP,924370151695,924373077072,2925377,-1
878,1,STEP,924373160972,924376637245,3476273,-1
879,1,STEP,924376723045,924379721822,2998777,-1
880,1,STEP,924379809321,924383399493,3590172,-1
881,1,STEP,924383484893,924386298971,2814078,-1
882,1,STEP,924386383171,924389036450,2653279,-1
883,1,STEP,924389120050,924391983728,2863678,-1
884,1,STEP,924392068727,924394764807,2696080,-1
885,1,STEP,924394848306,924398292780,3444474,-1
886,1,STEP,924398379279,924401345856,2966577,-1
887,1,STEP,924401429756,924404648031,3218275,-1
888,1,STEP,924404737530,924407502009,2764479,-1
889,1,STEP,924407588008,924410963083,3375075,-1
890,1,STEP,924411067982,924414128658,3060676,-1
891,1,STEP,924414210758,924417620332,3409574,-1
892,1,STEP,924417708231,924420813507,3105276,-1
893,1,STEP,924420900507,924423324188,2423681,-1
894,1,STEP,924423411387,924426429664,3018277,-1
895,1,STEP,924426517964,924429243943,2725979,-1
896,1,STEP,924429328542,924432539418,3210876,-1
897,1,STEP,924432623817,924435848092,3224275,-1
898,1,STEP,924435933592,924438679871,2746279,-1
899,1,STEP,924438772570,924442351642,3579072,-1
900,1,STEP,924442436642,924445112021,2675379,-1
901,1,STEP,924445196421,924448364896,3168475,-1
902,1,STEP,924448449496,924451387973,2938477,-1
903,1,STEP,924451474973,924454626049,3151076,-1
904,1,STEP,924454713348,924458015323,3301975,-1
905,1,STEP,924458114522,924460981300,2866778,-1
906,1,STEP,924461067099,924464314574,3247475,-1
907,1,STEP,924464402774,924467676149,3273375,-1
908,1,STEP,924467767148,924470608626,2841478,-1
909,1,STEP,924470697026,924473401005,2703979,-1
910,1,STEP,924473485104,924476252083,2766979,-1
911,1,STEP,924476341582,924479853056,3511474,-1
912,1,STEP,924479941655,924482481435,2539780,-1
913,1,STEP,924482567635,924485773110,3205475,-1
914,1,STEP,924485859710,924488999586,3139876,-1
915,1,STEP,924489091085,924492239161,3148076,-1
916,1,STEP,924492326760,924494970040,2643280,-1
917,1,STEP,924495061839,924497564720,2502881,-1
918,1,STEP,924497650519,924500661496,3010977,-1
919,1,STEP,924500748296,924504024271,3275975,-1
920,1,STEP,924504111170,924507508244,3397074,-1
921,1,STEP,924507600843,924511030617,3429774,-1
922,1,STEP,924511122016,924514031294,2909278,-1
923,1,STEP,924514116693,924517437868,3321175,-1
924,1,STEP,924517525167,924520195947,2670780,-1
925,1,STEP,924520281446,924523621721,3340275,-1
926,1,STEP,924523710020,924526850596,3140576,-1
927,1,STEP,924526937495,924529629875,2692380,-1
928,1,STEP,924529711674,924532472453,2760779,-1
929,1,STEP,924532568452,924535711628,3143176,-1
930,1,STEP,924535807528,924538706605,2899077,-1
931,1,STEP,924538804505,924541631783,2827278,-1
932,1,STEP,924541724582,924545258755,3534173,-1
933,1,STEP,924545355154,924548578430,3223276,-1
934,1,STEP,924548673929,924551994904,3320975,-1
935,1,STEP,924552092903,924555718475,3625572,-1
936,1,STEP,924555811875,924559285148,3473273,-1
937,1,STEP,924559381147,924562309225,2928078,-1
938,1,STEP,924562399724,924565789798,3390074,-1
939,1,STEP,924565919397,924568616677,2697280,-1
940,1,STEP,924568706676,924571849652,3142976,-1
941,1,STEP,924571939551,924574852629,2913078,-1
942,1,STEP,924574951228,924577752807,2801579,-1
943,1,STEP,924577849706,924580734184,2884478,-1
944,1,STEP,924580819883,924583988659,3168776,-1
945,1,STEP,924584065558,924587474432,3408874,-1
946,1,STEP,924587550632,924591164204,3613572,-1
947,1,STEP,924591243303,924594332580,3089277,-1
948,1,STEP,924594406779,924596761561,2354782,-1
949,1,STEP,924596833861,924600577432,3743571,-1
950,1,STEP,924600653831,924604022806,3368975,-1
951,1,STEP,924604097305,924607111882,3014577,-1
952,1,STEP,924607186181,924610596055,3409874,-1
953,1,STEP,924610670555,924613037637,2367082,-1
954,1,STEP,924613109336,924616374511,3265175,-1
955,1,STEP,924616449511,924619302089,2852578,-1
956,1,STEP,924619375388,924623054360,3678972,-1
957,1,STEP,924623130560,924626267936,3137376,-1
958,1,STEP,924626342735,924629317212,2974477,-1
959,1,STEP,924629389912,924632273090,2883178,-1
960,1,STEP,924632346689,924635472265,3125576,-1
961,1,STEP,924635547265,924638966638,3419373,-1
962,1,STEP,924639043438,924642306113,3262675,-1
963,1,STEP,924642381012,924645251690,2870678,-1
964,1,STEP,924645323790,924648447766,3123976,-1
965,1,STEP,924648521865,924652047738,3525873,-1
966,1,STEP,924652122238,924655225714,3103476,-1
967,1,STEP,924655300213,924658172291,2872078,-1
968,1,STEP,924658247391,924661272468,3025077,-1
969,1,STEP,924661345067,924663977747,2632680,-1
970,1,STEP,924664050246,924666755626,2705380,-1
971,1,STEP,924666830725,924669737803,2907078,-1
972,1,STEP,924669812402,924672831879,3019477,-1
973,1,STEP,924672905279,924675801157,2895878,-1
974,1,STEP,924675875056,924678881433,3006377,-1
975,1,STEP,924678957532,924682025309,3067777,-1
976,1,STEP,924682115808,924685358583,3242775,-1
977,1,STEP,924685432483,924688120662,2688179,-1
978,1,STEP,924688193562,924691348238,3154676,-1
979,1,STEP,924691423237,924694567513,3144276,-1
980,1,STEP,924694642612,924697743589,3100977,-1
981,1,STEP,924697817388,924700588867,2771479,-1
982,1,STEP,924700664866,924703716043,3051177,-1
983,1,STEP,924703792242,924706948418,3156176,-1
984,1,STEP,924707020118,924709786097,2765979,-1
985,1,STEP,924709862196,924712709374,2847178,-1
986,1,STEP,924712782174,924715400454,2618280,-1
987,1,STEP,924715473353,924718712628,3239275,-1
988,1,STEP,924718783428,924721841604,3058176,-1
989,1,STEP,924721924604,924724848881,2924277,-1
990,1,STEP,924724922681,924727421162,2498481,-1
991,1,STEP,924727493661,924730459438,2965777,-1
992,1,STEP,924730533838,924733429516,2895678,-1
993,1,STEP,924733503615,924736424993,2921378,-1
994,1,STEP,924736497292,924739288371,2791079,-1
995,1,STEP,924739362970,924742871543,3508573,-1
996,1,STEP,924742945443,924745849821,2904378,-1
997,1,STEP,924745944020,924749057496,3113476,-1
998,1,STEP,924749132096,924752382571,3250475,-1
999,1,STEP,924752457770,924755613846,3156076,-1
