Gen,Resource,Stamp,TimeStamp_Start,TimeStamp_End,Duration,Indiv_id
0,1,FirstEvaluation,733172492021,734073385946,900893925,-1
0,1,STEP,734073555644,734079465462,5909818,-1
1,1,STEP,734079538961,734084030699,4491738,-1
2,1,STEP,734084100698,734088994030,4893332,-1
3,1,STEP,734089063229,734093207771,4144542,-1
4,1,STEP,734093277370,734096702423,3425053,-1
5,1,STEP,734096770422,734101291960,4521538,-1
6,1,STEP,734101361459,734105687099,4325640,-1
7,1,STEP,734105756398,734109971239,4214841,-1
8,1,STEP,734110039138,734113571589,3532451,-1
9,1,STEP,734113635489,734118481221,4845732,-1
10,1,STEP,734118548621,734122050972,3502351,-1
11,1,STEP,734122114671,734127239800,5125129,-1
12,1,STEP,734127320599,734133519813,6199214,-1
13,1,STEP,734133663211,734138012251,4349040,-1
14,1,STEP,734138080650,734142320491,4239841,-1
15,1,STEP,734142388590,734145733844,3345254,-1
16,1,STEP,734145799543,734149947586,4148043,-1
17,1,STEP,734150014885,734154186627,4171742,-1
18,1,STEP,734154255726,734157848276,3592550,-1
19,1,STEP,734157939275,734161164030,3224755,-1
20,1,STEP,734161231029,734165490671,4259642,-1
21,1,STEP,734165557870,734169508015,3950145,-1
22,1,STEP,734169578014,734172958767,3380753,-1
23,1,STEP,734173074465,734177243808,4169343,-1
24,1,STEP,734177324307,734181968542,4644235,-1
25,1,STEP,734182049741,734186940873,4891132,-1
26,1,STEP,734187030472,734191376012,4345540,-1
27,1,STEP,734191456411,734195661653,4205242,-1
28,1,STEP,734195742952,734199423201,3680249,-1
29,1,STEP,734199499900,734204291433,4791533,-1
30,1,STEP,734204372632,734208178179,3805547,-1
31,1,STEP,734208261778,734212134625,3872847,-1
32,1,STEP,734212222823,734216096370,3873547,-1
33,1,STEP,734216176769,734219485723,3308954,-1
34,1,STEP,734219565422,734223095473,3530051,-1
35,1,STEP,734223176172,734226395127,3218955,-1
36,1,STEP,734226474726,734229956278,3481552,-1
37,1,STEP,734230032677,734233109034,3076357,-1
38,1,STEP,734233183033,734235986494,2803461,-1
39,1,STEP,734236060493,734239144451,3083958,-1
40,1,STEP,734239222050,734242541804,3319754,-1
41,1,STEP,734242621602,734245916857,3295255,-1
42,1,STEP,734245998456,734249778403,3779947,-1
43,1,STEP,734249860902,734253041158,3180256,-1
44,1,STEP,734253117157,734256242414,3125257,-1
45,1,STEP,734256325213,734259796365,3471152,-1
46,1,STEP,734259879963,734262973321,3093358,-1
47,1,STEP,734263050820,734265853581,2802761,-1
48,1,STEP,734265945279,734268913738,2968459,-1
49,1,STEP,734268989537,734271804998,2815461,-1
50,1,STEP,734271879697,734275211651,3331954,-1
51,1,STEP,734275289650,734278633404,3343754,-1
52,1,STEP,734278714603,734282370952,3656349,-1
53,1,STEP,734282451451,734285321811,2870360,-1
54,1,STEP,734285397610,734288636565,3238955,-1
55,1,STEP,734288713064,734292177216,3464152,-1
56,1,STEP,734292255315,734295721767,3466452,-1
57,1,STEP,734295808666,734298919823,3111157,-1
58,1,STEP,734299053121,734302528873,3475752,-1
59,1,STEP,734302612972,734305223836,2610864,-1
60,1,STEP,734305303334,734308192094,2888760,-1
61,1,STEP,734308278393,734311555748,3277355,-1
62,1,STEP,734311637447,734314559606,2922159,-1
63,1,STEP,734314639805,734317819361,3179556,-1
64,1,STEP,734317918260,734321574909,3656649,-1
65,1,STEP,734321656508,734326125946,4469438,-1
66,1,STEP,734326261044,734330071291,3810247,-1
67,1,STEP,734330171490,734333508144,3336654,-1
68,1,STEP,734333582943,734336458403,2875460,-1
69,1,STEP,734336531702,734339225665,2693963,-1
70,1,STEP,734339297464,734341816529,2519065,-1
71,1,STEP,734341897628,734345115983,3218355,-1
72,1,STEP,734345242981,734349398524,4155543,-1
73,1,STEP,734349482323,734353522867,4040544,-1
74,1,STEP,734353606866,734356721422,3114556,-1
75,1,STEP,734356803421,734359886579,3083158,-1
76,1,STEP,734359967977,734363058735,3090758,-1
77,1,STEP,734363191233,734366578086,3386853,-1
78,1,STEP,734366686584,734370593830,3907246,-1
79,1,STEP,734370672529,734373551189,2878660,-1
80,1,STEP,734373626888,734377597733,3970845,-1
81,1,STEP,734377711032,734381136584,3425552,-1
82,1,STEP,734381209283,734385068630,3859347,-1
83,1,STEP,734385196428,734389521668,4325240,-1
84,1,STEP,734389646566,734393306216,3659650,-1
85,1,STEP,734393388515,734396632670,3244155,-1
86,1,STEP,734396707869,734399875625,3167756,-1
87,1,STEP,734399951624,734403227578,3275954,-1
88,1,STEP,734403313277,734406500933,3187656,-1
89,1,STEP,734406577132,734409826487,3249355,-1
90,1,STEP,734409921486,734414564021,4642535,-1
91,1,STEP,734414704819,734418966460,4261641,-1
92,1,STEP,734419042959,734422470712,3427753,-1
93,1,STEP,734422548411,734425343572,2795161,-1
94,1,STEP,734425480270,734428856024,3375754,-1
95,1,STEP,734428931122,734432339775,3408653,-1
96,1,STEP,734432414074,734435576330,3162256,-1
97,1,STEP,734435694629,734438539689,2845060,-1
98,1,STEP,734438653688,734441510748,2857060,-1
99,1,STEP,734441626247,734445655891,4029644,-1
100,1,STEP,734445771589,734448458152,2686563,-1
101,1,STEP,734448574850,734451469710,2894860,-1
102,1,STEP,734451587609,734454676666,3089057,-1
103,1,STEP,734454793864,734457506327,2712463,-1
104,1,STEP,734457618725,734460530485,2911760,-1
105,1,STEP,734460643883,734464704627,4060744,-1
106,1,STEP,734464835525,734469506261,4670736,-1
107,1,STEP,734469654759,734474257295,4602536,-1
108,1,STEP,734474418793,734479779218,5360425,-1
109,1,STEP,734479916616,734484147058,4230442,-1
110,1,STEP,734484285356,734488503498,4218142,-1
111,1,STEP,734488591296,734492863537,4272241,-1
112,1,STEP,734492990635,734496291390,3300755,-1
113,1,STEP,734496370189,734499222749,2852560,-1
114,1,STEP,734499301648,734502935898,3634250,-1
115,1,STEP,734503068196,734506000755,2932559,-1
116,1,STEP,734506115554,734510185197,4069643,-1
117,1,STEP,734510268496,734513733748,3465252,-1
118,1,STEP,734513866146,734517383998,3517852,-1
119,1,STEP,734517498296,734520989148,3490852,-1
120,1,STEP,734521101146,734524612798,3511652,-1
121,1,STEP,734524725396,734528071650,3346254,-1
122,1,STEP,734528193948,734531349304,3155356,-1
123,1,STEP,734531471903,734534526660,3054757,-1
124,1,STEP,734534654558,734537900414,3245856,-1
125,1,STEP,734538022712,734541245067,3222355,-1
126,1,STEP,734541361766,734545838004,4476238,-1
127,1,STEP,734545976902,734551322728,5345826,-1
128,1,STEP,734551466926,734556240960,4774034,-1
129,1,STEP,734556384358,734560023307,3638949,-1
130,1,STEP,734560152805,734564563344,4410539,-1
131,1,STEP,734564696042,734568885484,4189442,-1
132,1,STEP,734568982183,734572283837,3301654,-1
133,1,STEP,734572364936,734575910287,3545351,-1
134,1,STEP,734576032385,734580612122,4579737,-1
135,1,STEP,734580733320,734585493954,4760634,-1
136,1,STEP,734585704252,734590098091,4393839,-1
137,1,STEP,734590203189,734594600728,4397539,-1
138,1,STEP,734594714327,734598362876,3648549,-1
139,1,STEP,734598470975,734601534432,3063457,-1
140,1,STEP,734601644531,734604761588,3117057,-1
141,1,STEP,734604874986,734608348738,3473752,-1
142,1,STEP,734608457136,734612473481,4016345,-1
143,1,STEP,734612586979,734616206029,3619050,-1
144,1,STEP,734616315528,734618999390,2683862,-1
145,1,STEP,734619113889,734623879123,4765234,-1
146,1,STEP,734624004221,734628209163,4204942,-1
147,1,STEP,734628334661,734631643415,3308754,-1
148,1,STEP,734631744214,734635230766,3486552,-1
149,1,STEP,734635304065,734638998514,3694449,-1
150,1,STEP,734639073413,734642707162,3633749,-1
151,1,STEP,734642781761,734646131415,3349654,-1
152,1,STEP,734646256213,734651303343,5047130,-1
153,1,STEP,734651436441,734654826194,3389753,-1
154,1,STEP,734654901993,734657785153,2883160,-1
155,1,STEP,734657850952,734662582487,4731535,-1
156,1,STEP,734662716085,734666921227,4205142,-1
157,1,STEP,734667054925,734671975257,4920332,-1
158,1,STEP,734672052556,734675575107,3522551,-1
159,1,STEP,734675649606,734678760363,3110757,-1
160,1,STEP,734678830962,734682415912,3584950,-1
161,1,STEP,734682542611,734687462742,4920131,-1
162,1,STEP,734687572041,734690852995,3280954,-1
163,1,STEP,734690925194,734695512631,4587437,-1
164,1,STEP,734695650829,734699291279,3640450,-1
165,1,STEP,734699423277,734702700431,3277154,-1
166,1,STEP,734702774630,734705749589,2974959,-1
167,1,STEP,734705823788,734708890946,3067158,-1
168,1,STEP,734708962545,734712208200,3245655,-1
169,1,STEP,734712279399,734715174159,2894760,-1
170,1,STEP,734715245758,734718445413,3199655,-1
171,1,STEP,734718534112,734721922865,3388753,-1
172,1,STEP,734721996564,734724617128,2620564,-1
173,1,STEP,734724687527,734727823584,3136057,-1
174,1,STEP,734727940782,734731146838,3206056,-1
175,1,STEP,734731218137,734733973898,2755761,-1
176,1,STEP,734734042697,734737273753,3231056,-1
177,1,STEP,734737345452,734740438809,3093357,-1
178,1,STEP,734740509408,734743110972,2601564,-1
179,1,STEP,734743181471,734747030918,3849447,-1
180,1,STEP,734747104817,734749742580,2637763,-1
181,1,STEP,734749806079,734752595541,2789462,-1
182,1,STEP,734752664140,734755389502,2725362,-1
183,1,STEP,734755458301,734758365261,2906960,-1
184,1,STEP,734758465759,734761832313,3366554,-1
185,1,STEP,734761910612,734765086568,3175956,-1
186,1,STEP,734765156667,734767706331,2549664,-1
187,1,STEP,734767835429,734771035985,3200556,-1
188,1,STEP,734771109584,734774011644,2902060,-1
189,1,STEP,734774081443,734776565709,2484266,-1
190,1,STEP,734776632508,734779292171,2659663,-1
191,1,STEP,734779359970,734782308629,2948659,-1
192,1,STEP,734782380528,734785663683,3283155,-1
193,1,STEP,734785794381,734790017522,4223141,-1
194,1,STEP,734790150520,734794221264,4070744,-1
195,1,STEP,734794350362,734797812714,3462352,-1
196,1,STEP,734797893313,734801459264,3565951,-1
197,1,STEP,734801532663,734804772918,3240255,-1
198,1,STEP,734804847517,734808521566,3674049,-1
199,1,STEP,734808667464,734812599210,3931746,-1
200,1,STEP,734812724308,734815977663,3253355,-1
201,1,STEP,734816049862,734819007621,2957759,-1
202,1,STEP,734819081220,734822268576,3187356,-1
203,1,STEP,734822342075,734825132036,2789961,-1
204,1,STEP,734825201635,734828449890,3248255,-1
205,1,STEP,734828520989,734831501748,2980759,-1
206,1,STEP,734831572347,734835590591,4018244,-1
207,1,STEP,734835664790,734838724748,3059958,-1
208,1,STEP,734838798747,734841758306,2959559,-1
209,1,STEP,734841832005,734845017361,3185356,-1
210,1,STEP,734845090960,734847685324,2594364,-1
211,1,STEP,734847753623,734851395972,3642349,-1
212,1,STEP,734851491971,734855028322,3536351,-1
213,1,STEP,734855107221,734858812370,3705149,-1
214,1,STEP,734858892569,734862562318,3669749,-1
215,1,STEP,734862689216,734866144068,3454852,-1
216,1,STEP,734866226067,734870152313,3926246,-1
217,1,STEP,734870267611,734873393568,3125957,-1
218,1,STEP,734873475967,734877295814,3819847,-1
219,1,STEP,734877387712,734880668767,3281055,-1
220,1,STEP,734880757766,734884669012,3911246,-1
221,1,STEP,734884743511,734888344461,3600950,-1
222,1,STEP,734888477459,734894145280,5667821,-1
223,1,STEP,734894223579,734897590633,3367054,-1
224,1,STEP,734897666232,734900979186,3312954,-1
225,1,STEP,734901055885,734904210841,3154956,-1
226,1,STEP,734904284740,734907273699,2988959,-1
227,1,STEP,734907347898,734910442755,3094857,-1
228,1,STEP,734910520254,734913453513,2933259,-1
229,1,STEP,734913528912,734916594170,3065258,-1
230,1,STEP,734916670668,734920064621,3393953,-1
231,1,STEP,734920138620,734923252877,3114257,-1
232,1,STEP,734923326676,734925924440,2597764,-1
233,1,STEP,734925997639,734929142496,3144857,-1
234,1,STEP,734929217595,734933031542,3813947,-1
235,1,STEP,734933105841,734937019387,3913546,-1
236,1,STEP,734937164185,734940144743,2980558,-1
237,1,STEP,734940218542,734943942591,3724049,-1
238,1,STEP,734944017390,734946799651,2782261,-1
239,1,STEP,734946875850,734950030906,3155056,-1
240,1,STEP,734950106305,734953421760,3315455,-1
241,1,STEP,734953495059,734956724614,3229555,-1
242,1,STEP,734956795813,734960050468,3254655,-1
243,1,STEP,734960125067,734963327522,3202455,-1
244,1,STEP,734963402021,734966715875,3313854,-1
245,1,STEP,734966789274,734970472723,3683449,-1
246,1,STEP,734970547922,734972907190,2359268,-1
247,1,STEP,734972976889,734975640052,2663163,-1
248,1,STEP,734975712451,734978774608,3062157,-1
249,1,STEP,734978847707,734981898665,3050958,-1
250,1,STEP,734981970364,734985560015,3589651,-1
251,1,STEP,734985634713,734988674971,3040258,-1
252,1,STEP,734988747170,734991987226,3240056,-1
253,1,STEP,734992059824,734994804186,2744362,-1
254,1,STEP,734994878385,734997940143,3061758,-1
255,1,STEP,734998009842,735001077700,3067858,-1
256,1,STEP,735001185598,735004328555,3142957,-1
257,1,STEP,735004403154,735007688208,3285054,-1
258,1,STEP,735007759507,735010366371,2606864,-1
259,1,STEP,735010436070,735013582026,3145956,-1
260,1,STEP,735013651626,735017189177,3537551,-1
261,1,STEP,735017261176,735020180435,2919259,-1
262,1,STEP,735020252134,735023121594,2869460,-1
263,1,STEP,735023190693,735026972341,3781648,-1
264,1,STEP,735027047640,735030075498,3027858,-1
265,1,STEP,735030148597,735032671762,2523165,-1
266,1,STEP,735032744361,735035948517,3204156,-1
267,1,STEP,735036023616,735039392169,3368553,-1
268,1,STEP,735039465168,735041898934,2433766,-1
269,1,STEP,735041970633,735045001291,3030658,-1
270,1,STEP,735045075090,735048613641,3538551,-1
271,1,STEP,735048733940,735053396275,4662335,-1
272,1,STEP,735053473674,735056721429,3247755,-1
273,1,STEP,735056798228,735059312793,2514565,-1
274,1,STEP,735059394192,735062147254,2753062,-1
275,1,STEP,735062221353,735065744104,3522751,-1
276,1,STEP,735065821303,735069236556,3415253,-1
277,1,STEP,735069313255,735072204215,2890960,-1
278,1,STEP,735072277814,735075397670,3119856,-1
279,1,STEP,735075471269,735078553027,3081758,-1
280,1,STEP,735078626226,735081774582,3148356,-1
281,1,STEP,735081848781,735084455345,2606564,-1
282,1,STEP,735084528644,735087413504,2884860,-1
283,1,STEP,735087487003,735090377663,2890660,-1
284,1,STEP,735090450562,735093575619,3125057,-1
285,1,STEP,735093649018,735096809074,3160056,-1
286,1,STEP,735096882273,735100097328,3215055,-1
287,1,STEP,735100169527,735103268685,3099158,-1
288,1,STEP,735103343983,735106459240,3115257,-1
289,1,STEP,735106534239,735108963806,2429567,-1
290,1,STEP,735109038805,735111948064,2909259,-1
291,1,STEP,735112026763,735114816425,2789662,-1
292,1,STEP,735114903523,735118461774,3558251,-1
293,1,STEP,735118548273,735122095024,3546751,-1
294,1,STEP,735122170823,735125235680,3064857,-1
295,1,STEP,735125307079,735129107127,3800048,-1
296,1,STEP,735129223125,735133114671,3891546,-1
297,1,STEP,735133229870,735136201828,2971958,-1
298,1,STEP,735136317327,735139384084,3066757,-1
299,1,STEP,735139493883,735142506141,3012258,-1
300,1,STEP,735142620140,735145637298,3017158,-1
301,1,STEP,735145752996,735148506258,2753262,-1
302,1,STEP,735148624256,735151775613,3151357,-1
303,1,STEP,735151892211,735154845370,2953159,-1
304,1,STEP,735154961469,735158044026,3082557,-1
305,1,STEP,735158161524,735161320181,3158657,-1
306,1,STEP,735161435779,735165572722,4136943,-1
307,1,STEP,735165705020,735169054674,3349654,-1
308,1,STEP,735169126973,735172011433,2884460,-1
309,1,STEP,735172081832,735174489298,2407466,-1
310,1,STEP,735174558697,735178505643,3946946,-1
311,1,STEP,735178582642,735181720398,3137756,-1
312,1,STEP,735181793297,735184851955,3058658,-1
313,1,STEP,735184923654,735187915912,2992258,-1
314,1,STEP,735187989011,735190920371,2931360,-1
315,1,STEP,735190995070,735194395723,3400653,-1
316,1,STEP,735194469022,735197435381,2966359,-1
317,1,STEP,735197509980,735200245842,2735862,-1
318,1,STEP,735200318241,735203398898,3080657,-1
319,1,STEP,735203472197,735206691452,3219255,-1
320,1,STEP,735206765451,735209744910,2979459,-1
321,1,STEP,735209816409,735213106464,3290055,-1
322,1,STEP,735213180263,735216196621,3016358,-1
323,1,STEP,735216269020,735219595274,3326254,-1
324,1,STEP,735219669173,735222399535,2730362,-1
325,1,STEP,735222471534,735225607590,3136056,-1
326,1,STEP,735225679189,735229069242,3390053,-1
327,1,STEP,735229144341,735232102100,2957759,-1
328,1,STEP,735232177299,735234781763,2604464,-1
329,1,STEP,735234854462,735237823521,2969059,-1
330,1,STEP,735237917220,735241005577,3088357,-1
331,1,STEP,735241078976,735244106834,3027858,-1
332,1,STEP,735244181533,735246640199,2458666,-1
333,1,STEP,735246714098,735249845555,3131457,-1
334,1,STEP,735249931054,735252992011,3060957,-1
335,1,STEP,735253067210,735255830572,2763362,-1
336,1,STEP,735255906671,735258932029,3025358,-1
337,1,STEP,735259005728,735261991987,2986259,-1
338,1,STEP,735262066186,735265151943,3085757,-1
339,1,STEP,735265226042,735268064002,2837960,-1
340,1,STEP,735268137401,735271399756,3262355,-1
341,1,STEP,735271474755,735274861208,3386453,-1
342,1,STEP,735274949107,735278233862,3284755,-1
343,1,STEP,735278309761,735281565616,3255855,-1
344,1,STEP,735281640614,735284819770,3179156,-1
345,1,STEP,735284894469,735287752730,2858261,-1
346,1,STEP,735287826129,735290763688,2937559,-1
347,1,STEP,735290838587,735293897545,3058958,-1
348,1,STEP,735293973344,735297349497,3376153,-1
349,1,STEP,735297425196,735300677651,3252455,-1
350,1,STEP,735300754850,735303776408,3021558,-1
351,1,STEP,735303851907,735306865065,3013158,-1
352,1,STEP,735306939864,735310202119,3262255,-1
353,1,STEP,735310277518,735314278663,4001145,-1
354,1,STEP,735314411361,735318580203,4168842,-1
355,1,STEP,735318660002,735322229652,3569650,-1
356,1,STEP,735322305851,735326333796,4027945,-1
357,1,STEP,735326469794,735330753134,4283340,-1
358,1,STEP,735330831433,735333661594,2830161,-1
359,1,STEP,735333737493,735336798951,3061458,-1
360,1,STEP,735336873350,735340277703,3404353,-1
361,1,STEP,735340354801,735343309161,2954360,-1
362,1,STEP,735343384959,735346004323,2619364,-1
363,1,STEP,735346077322,735348563688,2486366,-1
364,1,STEP,735348635787,735351551446,2915659,-1
365,1,STEP,735351626245,735354727802,3101557,-1
366,1,STEP,735354801901,735358084656,3282755,-1
367,1,STEP,735358160055,735361118714,2958659,-1
368,1,STEP,735361191713,735363919675,2727962,-1
369,1,STEP,735363990274,735366827735,2837461,-1
370,1,STEP,735366898134,735369275801,2377667,-1
371,1,STEP,735369347400,735372467257,3119857,-1
372,1,STEP,735372541256,735375715912,3174656,-1
373,1,STEP,735375785911,735378641171,2855260,-1
374,1,STEP,735378757170,735381809727,3052557,-1
375,1,STEP,735381895326,735384675188,2779862,-1
376,1,STEP,735384748787,735387399550,2650763,-1
377,1,STEP,735387471249,735390363709,2892460,-1
378,1,STEP,735390436008,735393104871,2668863,-1
379,1,STEP,735393176170,735396036630,2860460,-1
380,1,STEP,735396109429,735399163987,3054558,-1
381,1,STEP,735399237086,735401763351,2526265,-1
382,1,STEP,735401836450,735405066005,3229555,-1
383,1,STEP,735405139304,735407989365,2850061,-1
384,1,STEP,735408061764,735411132721,3070957,-1
385,1,STEP,735411207320,735414110380,2903060,-1
386,1,STEP,735414182679,735417372635,3189956,-1
387,1,STEP,735417472334,735420573191,3100857,-1
388,1,STEP,735420655989,735423764746,3108757,-1
389,1,STEP,735423853645,735426517408,2663763,-1
390,1,STEP,735426603407,735429634865,3031458,-1
391,1,STEP,735429715164,735432673623,2958459,-1
392,1,STEP,735432758222,735435902978,3144756,-1
393,1,STEP,735435986777,735439044535,3057758,-1
394,1,STEP,735439126534,735442134892,3008358,-1
395,1,STEP,735442219191,735445559245,3340054,-1
396,1,STEP,735445643443,735448641602,2998159,-1
397,1,STEP,735448723701,735451526662,2802961,-1
398,1,STEP,735451612161,735454598419,2986258,-1
399,1,STEP,735454681118,735458194570,3513452,-1
400,1,STEP,735458284668,735461366926,3082258,-1
401,1,STEP,735461450925,735464269386,2818461,-1
402,1,STEP,735464355884,735466901349,2545465,-1
403,1,STEP,735466984948,735470105805,3120857,-1
404,1,STEP,735470187904,735472800067,2612163,-1
405,1,STEP,735472882466,735476015223,3132757,-1
406,1,STEP,735476097522,735479851570,3754048,-1
407,1,STEP,735479987368,735484029412,4042044,-1
408,1,STEP,735484107311,735487493364,3386053,-1
409,1,STEP,735487570363,735491147413,3577050,-1
410,1,STEP,735491226412,735494404168,3177756,-1
411,1,STEP,735494481567,735497847121,3365554,-1
412,1,STEP,735497942819,735500762880,2820061,-1
413,1,STEP,735500837479,735504410030,3572551,-1
414,1,STEP,735504486929,735507487487,3000558,-1
415,1,STEP,735507562486,735510049052,2486566,-1
416,1,STEP,735510123951,735513413805,3289854,-1
417,1,STEP,735513491304,735516361864,2870560,-1
418,1,STEP,735516438463,735520057813,3619350,-1
419,1,STEP,735520172811,735523847860,3675049,-1
420,1,STEP,735523947859,735527789506,3841647,-1
421,1,STEP,735527925704,735532404442,4478738,-1
422,1,STEP,735532539040,735537707369,5168329,-1
423,1,STEP,735537840567,735542925896,5085329,-1
424,1,STEP,735543067894,735547512133,4444239,-1
425,1,STEP,735547642931,735552495364,4852433,-1
426,1,STEP,735552629062,735557943688,5314626,-1
427,1,STEP,735558091486,735562203329,4111843,-1
428,1,STEP,735562333528,735567250559,4917031,-1
429,1,STEP,735567358758,735570795710,3436952,-1
430,1,STEP,735570872709,735573659771,2787062,-1
431,1,STEP,735573733370,735576789327,3055957,-1
432,1,STEP,735576862926,735579567489,2704563,-1
433,1,STEP,735579638788,735583138239,3499451,-1
434,1,STEP,735583212438,735585849802,2637364,-1
435,1,STEP,735585942801,735589212255,3269454,-1
436,1,STEP,735589284954,735592121715,2836761,-1
437,1,STEP,735592194114,735595267272,3073158,-1
438,1,STEP,735595339971,735598775423,3435452,-1
439,1,STEP,735598846022,735601984678,3138656,-1
440,1,STEP,735602065077,735604957037,2891960,-1
441,1,STEP,735605036936,735607600701,2563765,-1
442,1,STEP,735607677000,735610875655,3198655,-1
443,1,STEP,735610956354,735614866600,3910246,-1
444,1,STEP,735614954199,735618453150,3498951,-1
445,1,STEP,735618535549,735621033015,2497466,-1
446,1,STEP,735621111814,735624421068,3309254,-1
447,1,STEP,735624503967,735627223929,2719962,-1
448,1,STEP,735627305928,735630229587,2923659,-1
449,1,STEP,735630318486,735633395044,3076558,-1
450,1,STEP,735633478342,735636246404,2768062,-1
451,1,STEP,735636330103,735639333261,3003158,-1
452,1,STEP,735639418660,735642548317,3129657,-1
453,1,STEP,735642632716,735645648374,3015658,-1
454,1,STEP,735645732173,735648787230,3055057,-1
455,1,STEP,735648870729,735652051885,3181156,-1
456,1,STEP,735652136984,735655130143,2993159,-1
457,1,STEP,735655214941,735658235500,3020559,-1
458,1,STEP,735658323398,735661339657,3016259,-1
459,1,STEP,735661423655,735664693310,3269655,-1
460,1,STEP,735664781509,735667879366,3097857,-1
461,1,STEP,735667963265,735671116221,3152956,-1
462,1,STEP,735671205520,735674207278,3001758,-1
463,1,STEP,735674291177,735677518733,3227556,-1
464,1,STEP,735677610131,735680938285,3328154,-1
465,1,STEP,735681023484,735685149927,4126443,-1
466,1,STEP,735685244726,735688754977,3510251,-1
467,1,STEP,735688847976,735692107331,3259355,-1
468,1,STEP,735692193529,735695597982,3404453,-1
469,1,STEP,735695683481,735699087734,3404253,-1
470,1,STEP,735699179833,735702739483,3559650,-1
471,1,STEP,735702824982,735705737642,2912660,-1
472,1,STEP,735705822241,735709443090,3620849,-1
473,1,STEP,735709528889,735712837243,3308354,-1
474,1,STEP,735712922342,735716567192,3644850,-1
475,1,STEP,735716653591,735719457452,2803861,-1
476,1,STEP,735719540751,735722583408,3042657,-1
477,1,STEP,735722669907,735725823464,3153557,-1
478,1,STEP,735725930562,735729429914,3499352,-1
479,1,STEP,735729515012,735732563270,3048258,-1
480,1,STEP,735732646669,735735535029,2888360,-1
481,1,STEP,735735617628,735738661786,3044158,-1
482,1,STEP,735738744585,735741187151,2442566,-1
483,1,STEP,735741265650,735744174310,2908660,-1
484,1,STEP,735744261108,735747390965,3129857,-1
485,1,STEP,735747479864,735751119213,3639349,-1
486,1,STEP,735751207012,735753959374,2752362,-1
487,1,STEP,735754038873,735756836334,2797461,-1
488,1,STEP,735756913633,735760339786,3426153,-1
489,1,STEP,735760428084,735763635540,3207456,-1
490,1,STEP,735763716239,735766609899,2893660,-1
491,1,STEP,735766693898,735769380960,2687062,-1
492,1,STEP,735769460359,735772942711,3482352,-1
493,1,STEP,735773025010,735775745572,2720562,-1
494,1,STEP,735775829671,735778687132,2857461,-1
495,1,STEP,735778770630,735781633391,2862761,-1
496,1,STEP,735781713690,735785985031,4271341,-1
497,1,STEP,735786124429,735789636280,3511851,-1
498,1,STEP,735789709579,735793804122,4094543,-1
499,1,STEP,735793890621,735797187175,3296554,-1
500,1,STEP,735797258874,735800687127,3428253,-1
501,1,STEP,735800760426,735803605687,2845261,-1
502,1,STEP,735803678886,735806797542,3118656,-1
503,1,STEP,735806875541,735811686775,4811234,-1
504,1,STEP,735811818773,735815601320,3782547,-1
505,1,STEP,735815721019,735818740577,3019558,-1
506,1,STEP,735818817476,735821648437,2830961,-1
507,1,STEP,735821723036,735824847592,3124556,-1
508,1,STEP,735824923291,735828022748,3099457,-1
509,1,STEP,735828096947,735831055206,2958259,-1
510,1,STEP,735831132405,735834076465,2944060,-1
511,1,STEP,735834150364,735837208121,3057757,-1
512,1,STEP,735837318420,735840350478,3032058,-1
513,1,STEP,735840423977,735843270337,2846360,-1
514,1,STEP,735843345636,735846536292,3190656,-1
515,1,STEP,735846610491,735849521351,2910860,-1
516,1,STEP,735849596350,735852892504,3296154,-1
517,1,STEP,735852967203,735856033461,3066258,-1
518,1,STEP,735856106860,735859532412,3425552,-1
519,1,STEP,735859622311,735862894466,3272155,-1
520,1,STEP,735862988964,735867959095,4970131,-1
521,1,STEP,735868096693,735871923840,3827147,-1
522,1,STEP,735872027439,735877064069,5036630,-1
523,1,STEP,735877198067,735882413395,5215328,-1
524,1,STEP,735882550493,735887752221,5201728,-1
525,1,STEP,735887894419,735893342944,5448525,-1
526,1,STEP,735893479742,735897191991,3712249,-1
527,1,STEP,735897318889,735901558730,4239841,-1
528,1,STEP,735901690128,735905579274,3889146,-1
529,1,STEP,735905713173,735909896415,4183242,-1
530,1,STEP,735910022913,735913535264,3512351,-1
531,1,STEP,735913657363,735917736206,4078843,-1
532,1,STEP,735917858804,735921165259,3306455,-1
533,1,STEP,735921286857,735925013205,3726348,-1
534,1,STEP,735925137104,735928363359,3226255,-1
535,1,STEP,735928487157,735932091607,3604450,-1
536,1,STEP,735932178006,735935628358,3450352,-1
537,1,STEP,735935751157,735938643317,2892160,-1
538,1,STEP,735938773615,735943207553,4433938,-1
539,1,STEP,735943297352,735946040814,2743462,-1
540,1,STEP,735946126313,735949220670,3094357,-1
541,1,STEP,735949338068,735953685808,4347740,-1
542,1,STEP,735953772607,735956305172,2532565,-1
543,1,STEP,735956398771,735959757324,3358553,-1
544,1,STEP,735959888122,735962946480,3058358,-1
545,1,STEP,735963028079,735966908425,3880346,-1
546,1,STEP,735966996224,735969745786,2749562,-1
547,1,STEP,735969828285,735973422835,3594550,-1
548,1,STEP,735973551533,735977336481,3784948,-1
549,1,STEP,735977414480,735981062729,3648249,-1
550,1,STEP,735981141028,735984409983,3268955,-1
551,1,STEP,735984487482,735987574839,3087357,-1
552,1,STEP,735987650538,735990893793,3243255,-1
553,1,STEP,735991002792,735995048535,4045743,-1
554,1,STEP,735995155634,735999077980,3922346,-1
555,1,STEP,735999183678,736003097024,3913346,-1
556,1,STEP,736003190023,736006566676,3376653,-1
557,1,STEP,736006686174,736010067128,3380954,-1
558,1,STEP,736010162826,736014099372,3936546,-1
559,1,STEP,736014199370,736017718122,3518752,-1
560,1,STEP,736017842120,736021601068,3758948,-1
561,1,STEP,736021734566,736025716611,3982045,-1
562,1,STEP,736025797210,736029261462,3464252,-1
563,1,STEP,736029405460,736033622001,4216541,-1
564,1,STEP,736033754100,736038136239,4382139,-1
565,1,STEP,736038270037,736043142270,4872233,-1
566,1,STEP,736043276068,736047338911,4062843,-1
567,1,STEP,736047442910,736050822763,3379853,-1
568,1,STEP,736050901862,736053710423,2808561,-1
569,1,STEP,736053784122,736056889679,3105557,-1
570,1,STEP,736056966478,736060414930,3448452,-1
571,1,STEP,736060493029,736063994381,3501352,-1
572,1,STEP,736064072380,736067044639,2972259,-1
573,1,STEP,736067119037,736070259594,3140557,-1
574,1,STEP,736070335493,736073500949,3165456,-1
575,1,STEP,736073575148,736077032000,3456852,-1
576,1,STEP,736077112199,736080793248,3681049,-1
577,1,STEP,736080925646,736085479483,4553837,-1
578,1,STEP,736085627481,736090684211,5056730,-1
579,1,STEP,736090819709,736095290947,4471238,-1
580,1,STEP,736095404346,736098719700,3315354,-1
581,1,STEP,736098839198,736103040740,4201542,-1
582,1,STEP,736103164738,736107948272,4783534,-1
583,1,STEP,736108035171,736112292612,4257441,-1
584,1,STEP,736112455110,736117189544,4734434,-1
585,1,STEP,736117332042,736121205489,3873447,-1
586,1,STEP,736121283187,736125035335,3752148,-1
587,1,STEP,736125165834,736128741084,3575250,-1
588,1,STEP,736128829983,736132370234,3540251,-1
589,1,STEP,736132456033,736135412692,2956659,-1
590,1,STEP,736135498291,736138769145,3270854,-1
591,1,STEP,736138853144,736142477594,3624450,-1
592,1,STEP,736142606292,736146556637,3950345,-1
593,1,STEP,736146644636,736149635695,2991059,-1
594,1,STEP,736149718794,736153054247,3335453,-1
595,1,STEP,736153146146,736156891994,3745848,-1
596,1,STEP,736157017593,736159815054,2797461,-1
597,1,STEP,736159940952,736162896511,2955559,-1
598,1,STEP,736163032609,736165947369,2914760,-1
599,1,STEP,736166067067,736169522219,3455152,-1
600,1,STEP,736169639418,736172939172,3299754,-1
601,1,STEP,736173061270,736176358025,3296755,-1
602,1,STEP,736176475723,736179627280,3151557,-1
603,1,STEP,736179742978,736182955633,3212655,-1
604,1,STEP,736183071632,736186010491,2938859,-1
605,1,STEP,736186127989,736190091735,3963746,-1
606,1,STEP,736190209333,736194073679,3864346,-1
607,1,STEP,736194209978,736199149809,4939831,-1
608,1,STEP,736199281307,736203287352,4006045,-1
609,1,STEP,736203405850,736206729504,3323654,-1
610,1,STEP,736206844703,736210019959,3175256,-1
611,1,STEP,736210138257,736212805620,2667363,-1
612,1,STEP,736212919618,736215808878,2889260,-1
613,1,STEP,736215923777,736218677139,2753362,-1
614,1,STEP,736218793937,736222146591,3352654,-1
615,1,STEP,736222261089,736225331547,3070458,-1
616,1,STEP,736225447045,736228268506,2821461,-1
617,1,STEP,736228387504,736230986168,2598664,-1
618,1,STEP,736231104167,736234342122,3237955,-1
619,1,STEP,736234458720,736237709675,3250955,-1
620,1,STEP,736237786674,736241176627,3389953,-1
621,1,STEP,736241252526,736244017488,2764962,-1
622,1,STEP,736244090187,736246907748,2817561,-1
623,1,STEP,736246982247,736250092704,3110457,-1
624,1,STEP,736250167803,736253434557,3266754,-1
625,1,STEP,736253508356,736256794611,3286255,-1
626,1,STEP,736256871410,736259811569,2940159,-1
627,1,STEP,736259886168,736263245822,3359654,-1
628,1,STEP,736263338320,736266595975,3257655,-1
629,1,STEP,736266682474,736269671333,2988859,-1
630,1,STEP,736269755631,736273320082,3564451,-1
631,1,STEP,736273413881,736276318641,2904760,-1
632,1,STEP,736276405939,736279413398,3007459,-1
633,1,STEP,736279507196,736282599954,3092758,-1
634,1,STEP,736282676753,736285609912,2933159,-1
635,1,STEP,736285681811,736288570471,2888660,-1
636,1,STEP,736288641970,736291120236,2478266,-1
637,1,STEP,736291192635,736294749985,3557350,-1
638,1,STEP,736294825184,736298029640,3204456,-1
639,1,STEP,736298103839,736300813601,2709762,-1
640,1,STEP,736300886400,736303811560,2925160,-1
641,1,STEP,736303882259,736307014216,3131957,-1
642,1,STEP,736307089114,736310103173,3014059,-1
643,1,STEP,736310177472,736313086631,2909159,-1
644,1,STEP,736313161130,736316367786,3206656,-1
645,1,STEP,736316439885,736319507243,3067358,-1
646,1,STEP,736319581141,736322630699,3049558,-1
647,1,STEP,736322703598,736326109451,3405853,-1
648,1,STEP,736326183950,736329216408,3032458,-1
649,1,STEP,736329288507,736332830058,3541551,-1
650,1,STEP,736332904257,736335862116,2957859,-1
651,1,STEP,736335935615,736338619878,2684263,-1
652,1,STEP,736338691977,736341967331,3275354,-1
653,1,STEP,736342039330,736344871191,2831861,-1
654,1,STEP,736344943990,736348256844,3312854,-1
655,1,STEP,736348327043,736352085091,3758048,-1
656,1,STEP,736352174290,736355493444,3319154,-1
657,1,STEP,736355567743,736358796398,3228655,-1
658,1,STEP,736358873897,736361582360,2708463,-1
659,1,STEP,736361656559,736365149110,3492551,-1
660,1,STEP,736365228709,736368681462,3452753,-1
661,1,STEP,736368756461,736372101214,3344753,-1
662,1,STEP,736372176013,736375432068,3256055,-1
663,1,STEP,736375507867,736378849921,3342054,-1
664,1,STEP,736378927020,736382029777,3102757,-1
665,1,STEP,736382104676,736385551528,3446852,-1
666,1,STEP,736385626727,736388892982,3266255,-1
667,1,STEP,736388984780,736392079838,3095058,-1
668,1,STEP,736392172936,736395132595,2959659,-1
669,1,STEP,736395227294,736397837058,2609764,-1
670,1,STEP,736397943456,736401808803,3865347,-1
671,1,STEP,736401921601,736405342654,3421053,-1
672,1,STEP,736405426353,736408845705,3419352,-1
673,1,STEP,736408932304,736411858264,2925960,-1
674,1,STEP,736411945462,736414899722,2954260,-1
675,1,STEP,736414984620,736418270675,3286055,-1
676,1,STEP,736418360274,736421198434,2838160,-1
677,1,STEP,736421286433,736424488989,3202556,-1
678,1,STEP,736424580887,736427148952,2568065,-1
679,1,STEP,736427235751,736430564905,3329154,-1
680,1,STEP,736430650903,736434234954,3584051,-1
681,1,STEP,736434327453,736438560294,4232841,-1
682,1,STEP,736438705392,736444094717,5389325,-1
683,1,STEP,736444226915,736448656254,4429339,-1
684,1,STEP,736448733053,736452009408,3276355,-1
685,1,STEP,736452082707,736455567758,3485051,-1
686,1,STEP,736455644257,736458517318,2873061,-1
687,1,STEP,736458589917,736462208866,3618949,-1
688,1,STEP,736462289865,736465091027,2801162,-1
689,1,STEP,736465162126,736468394381,3232255,-1
690,1,STEP,736468471980,736471913032,3441052,-1
691,1,STEP,736472023331,736475775779,3752448,-1
692,1,STEP,736475851678,736479951721,4100043,-1
693,1,STEP,736480083119,736482855281,2772162,-1
694,1,STEP,736482969479,736485831639,2862160,-1
695,1,STEP,736485952338,736488790798,2838460,-1
696,1,STEP,736488904197,736491528460,2624263,-1
697,1,STEP,736491643259,736494456220,2812961,-1
698,1,STEP,736494568118,736497721875,3153757,-1
699,1,STEP,736497840473,736501233826,3393353,-1
700,1,STEP,736501352024,736504564480,3212456,-1
701,1,STEP,736504688378,736507787635,3099257,-1
702,1,STEP,736507898834,736511339086,3440252,-1
703,1,STEP,736511451185,736514402844,2951659,-1
704,1,STEP,736514526742,736517623199,3096457,-1
705,1,STEP,736517710898,736520302162,2591264,-1
706,1,STEP,736520383261,736522917226,2533965,-1
707,1,STEP,736522999225,736525931784,2932559,-1
708,1,STEP,736526016283,736529279238,3262955,-1
709,1,STEP,736529365336,736532501393,3136057,-1
710,1,STEP,736532587392,736535824447,3237055,-1
711,1,STEP,736535917246,736538585709,2668463,-1
712,1,STEP,736538672608,736541766765,3094157,-1
713,1,STEP,736541849564,736545561312,3711748,-1
714,1,STEP,736545646611,736548582870,2936259,-1
715,1,STEP,736548664069,736551821826,3157757,-1
716,1,STEP,736551910924,736554973982,3063058,-1
717,1,STEP,736555058181,736557790743,2732562,-1
718,1,STEP,736557881242,736560551705,2670463,-1
719,1,STEP,736560633203,736563702461,3069258,-1
720,1,STEP,736563785560,736567113814,3328254,-1
721,1,STEP,736567197413,736570120572,2923159,-1
722,1,STEP,736570208371,736573720922,3512551,-1
723,1,STEP,736573803721,736576788580,2984859,-1
724,1,STEP,736576870879,736580300431,3429552,-1
725,1,STEP,736580386030,736583675684,3289654,-1
726,1,STEP,736583767583,736586786341,3018758,-1
727,1,STEP,736586867640,736590017897,3150257,-1
728,1,STEP,736590100095,736593098554,2998459,-1
729,1,STEP,736593179253,736596621405,3442152,-1
730,1,STEP,736596703304,736600603650,3900346,-1
731,1,STEP,736600710749,736604336698,3625949,-1
732,1,STEP,736604412897,736607182559,2769662,-1
733,1,STEP,736607257158,736610130118,2872960,-1
734,1,STEP,736610203417,736612734582,2531165,-1
735,1,STEP,736612807381,736615678541,2871160,-1
736,1,STEP,736615754740,736618758899,3004159,-1
737,1,STEP,736618831398,736621496661,2665263,-1
738,1,STEP,736621565360,736624387321,2821961,-1
739,1,STEP,736624459420,736627545377,3085957,-1
740,1,STEP,736627621376,736630528036,2906660,-1
741,1,STEP,736630605035,736633399996,2794961,-1
742,1,STEP,736633474995,736636597852,3122857,-1
743,1,STEP,736636670951,736640293900,3622949,-1
744,1,STEP,736640369099,736643333758,2964659,-1
745,1,STEP,736643407557,736646737411,3329854,-1
746,1,STEP,736646812010,736649875268,3063258,-1
747,1,STEP,736649948567,736652500031,2551464,-1
748,1,STEP,736652567630,736655720687,3153057,-1
749,1,STEP,736655794686,736658227552,2432866,-1
750,1,STEP,736658300251,736661433308,3133057,-1
751,1,STEP,736661505707,736664663663,3157956,-1
752,1,STEP,736664735862,736667678121,2942259,-1
753,1,STEP,736667750620,736670263585,2512965,-1
754,1,STEP,736670335284,736673585639,3250355,-1
755,1,STEP,736673657138,736676250902,2593764,-1
756,1,STEP,736676319002,736679869652,3550650,-1
757,1,STEP,736679956651,736682936310,2979659,-1
758,1,STEP,736683010709,736686260564,3249855,-1
759,1,STEP,736686335363,736689542918,3207555,-1
760,1,STEP,736689615217,736692443878,2828661,-1
761,1,STEP,736692519277,736695801332,3282055,-1
762,1,STEP,736695875631,736698842690,2967059,-1
763,1,STEP,736698916189,736701693750,2777561,-1
764,1,STEP,736701762649,736704501711,2739062,-1
765,1,STEP,736704571210,736707332272,2761062,-1
766,1,STEP,736707404871,736710501628,3096757,-1
767,1,STEP,736710576027,736713946780,3370753,-1
768,1,STEP,736714033579,736716830041,2796462,-1
769,1,STEP,736716902640,736719252107,2349467,-1
770,1,STEP,736719323706,736722641960,3318254,-1
771,1,STEP,736722718159,736725707418,2989259,-1
772,1,STEP,736725780517,736728681976,2901459,-1
773,1,STEP,736728755975,736732305126,3549151,-1
774,1,STEP,736732381825,736735229186,2847361,-1
775,1,STEP,736735302685,736738332943,3030258,-1
776,1,STEP,736738406342,736741708596,3302254,-1
777,1,STEP,736741782595,736744633556,2850961,-1
778,1,STEP,736744705455,736747723013,3017558,-1
779,1,STEP,736747797112,736750993167,3196055,-1
780,1,STEP,736751068766,736753963726,2894960,-1
781,1,STEP,736754047225,736756592390,2545165,-1
782,1,STEP,736756663889,736759734046,3070157,-1
783,1,STEP,736759808945,736762641606,2832661,-1
784,1,STEP,736762713805,736765376768,2662963,-1
785,1,STEP,736765446767,736768459026,3012259,-1
786,1,STEP,736768533625,736771647481,3113856,-1
787,1,STEP,736771719480,736774399143,2679663,-1
788,1,STEP,736774475142,736777667998,3192856,-1
789,1,STEP,736777739297,736780829654,3090357,-1
790,1,STEP,736780901453,736784236507,3335054,-1
791,1,STEP,736784309606,736787368864,3059258,-1
792,1,STEP,736787438663,736790631919,3193256,-1
793,1,STEP,736790704918,736793789375,3084457,-1
794,1,STEP,736793858174,736797937517,4079343,-1
795,1,STEP,736798016416,736801367570,3351154,-1
796,1,STEP,736801445369,736804967020,3521651,-1
797,1,STEP,736805043419,736807710382,2666963,-1
798,1,STEP,736807782081,736811035836,3253755,-1
799,1,STEP,736811110835,736814036894,2926059,-1
800,1,STEP,736814110593,736816952254,2841661,-1
801,1,STEP,736817023153,736820418806,3395653,-1
802,1,STEP,736820493205,736823028270,2535065,-1
803,1,STEP,736823099869,736826773618,3673749,-1
804,1,STEP,736826848417,736830574465,3726048,-1
805,1,STEP,736830650864,736833594824,2943960,-1
806,1,STEP,736833667623,736836836679,3169056,-1
807,1,STEP,736836911778,736839996535,3084757,-1
808,1,STEP,736840070434,736842789296,2718862,-1
809,1,STEP,736842862695,736845734056,2871361,-1
810,1,STEP,736845807954,736848376219,2568265,-1
811,1,STEP,736848449618,736851542675,3093057,-1
812,1,STEP,736851618774,736854890929,3272155,-1
813,1,STEP,736854968028,736857933087,2965059,-1
814,1,STEP,736858009686,736860879146,2869460,-1
815,1,STEP,736860953145,736865112287,4159142,-1
816,1,STEP,736865197086,736869058433,3861347,-1
817,1,STEP,736869135131,736872393286,3258155,-1
818,1,STEP,736872468385,736875535243,3066858,-1
819,1,STEP,736875609342,736878710699,3101357,-1
820,1,STEP,736878801598,736881540060,2738462,-1
821,1,STEP,736881611559,736884612317,3000758,-1
822,1,STEP,736884685316,736887441578,2756262,-1
823,1,STEP,736887513977,736890678033,3164056,-1
824,1,STEP,736890751432,736893186598,2435166,-1
825,1,STEP,736893257597,736896014359,2756762,-1
826,1,STEP,736896086258,736899288814,3202556,-1
827,1,STEP,736899362113,736901804779,2442666,-1
828,1,STEP,736901884578,736904752038,2867460,-1
829,1,STEP,736904824937,736907756597,2931660,-1
830,1,STEP,736907829596,736910496159,2666563,-1
831,1,STEP,736910567258,736913525317,2958059,-1
832,1,STEP,736913595516,736916657873,3062357,-1
833,1,STEP,736916731672,736919358036,2626364,-1
834,1,STEP,736919431235,736922476593,3045358,-1
835,1,STEP,736922548892,736925406852,2857960,-1
836,1,STEP,736925478851,736928915404,3436553,-1
837,1,STEP,736928989503,736932122659,3133156,-1
838,1,STEP,736932244158,736936259502,4015344,-1
839,1,STEP,736936394000,736939954051,3560051,-1
840,1,STEP,736940041550,736943023408,2981858,-1
841,1,STEP,736943107807,736946094766,2986959,-1
842,1,STEP,736946198164,736949040025,2841861,-1
843,1,STEP,736949121524,736952478977,3357453,-1
844,1,STEP,736952567276,736955858631,3291355,-1
845,1,STEP,736955944529,736959283283,3338754,-1
846,1,STEP,736959392082,736962786935,3394853,-1
847,1,STEP,736962904233,736966291486,3387253,-1
848,1,STEP,736966409784,736969673439,3263655,-1
849,1,STEP,736969787638,736973390688,3603050,-1
850,1,STEP,736973509786,736976301847,2792061,-1
851,1,STEP,736976418746,736979764800,3346054,-1
852,1,STEP,736979885598,736983534347,3648749,-1
853,1,STEP,736983649846,736986990899,3341053,-1
854,1,STEP,736987119098,736989917259,2798161,-1
855,1,STEP,736990033757,736992956717,2922960,-1
856,1,STEP,736993073115,736995954975,2881860,-1
857,1,STEP,736996069974,736999219330,3149356,-1
858,1,STEP,736999336528,737002843680,3507152,-1
859,1,STEP,737002961378,737006589728,3628350,-1
860,1,STEP,737006701627,737010205378,3503751,-1
861,1,STEP,737010317476,737013667330,3349854,-1
862,1,STEP,737013781828,737017310880,3529052,-1
863,1,STEP,737017425478,737021043828,3618350,-1
864,1,STEP,737021159926,737024508980,3349054,-1
865,1,STEP,737024622878,737027917833,3294955,-1
866,1,STEP,737028037131,737030978890,2941759,-1
867,1,STEP,737031092489,737034362643,3270154,-1
868,1,STEP,737034495642,737037675698,3180056,-1
869,1,STEP,737037786796,737041412646,3625850,-1
870,1,STEP,737041528944,737044852898,3323954,-1
871,1,STEP,737044966997,737047828757,2861760,-1
872,1,STEP,737047941355,737051219610,3278255,-1
873,1,STEP,737051332608,737054612363,3279755,-1
874,1,STEP,737054722862,737057614821,2891959,-1
875,1,STEP,737057729920,737060953075,3223155,-1
876,1,STEP,737061080973,737064065532,2984559,-1
877,1,STEP,737064180231,737067089290,2909059,-1
878,1,STEP,737067206089,737070712140,3506051,-1
879,1,STEP,737070829838,737073972695,3142857,-1
880,1,STEP,737074061994,737077846341,3784347,-1
881,1,STEP,737077940940,737080610903,2669963,-1
882,1,STEP,737080681502,737083236167,2554665,-1
883,1,STEP,737083306066,737086073027,2766961,-1
884,1,STEP,737086146126,737088728291,2582165,-1
885,1,STEP,737088799290,737092173743,3374453,-1
886,1,STEP,737092247342,737095171501,2924159,-1
887,1,STEP,737095243700,737099040048,3796348,-1
888,1,STEP,737099132447,737102279203,3146756,-1
889,1,STEP,737102396501,737105822654,3426153,-1
890,1,STEP,737105954752,737109694700,3739948,-1
891,1,STEP,737109830898,737113243951,3413053,-1
892,1,STEP,737113319250,737116339908,3020658,-1
893,1,STEP,737116413407,737118829974,2416567,-1
894,1,STEP,737118902273,737121881032,2978759,-1
895,1,STEP,737121965830,737124653693,2687863,-1
896,1,STEP,737124725192,737127891248,3166056,-1
897,1,STEP,737127965747,737131202402,3236655,-1
898,1,STEP,737131294301,737134041463,2747162,-1
899,1,STEP,737134154162,737137774811,3620649,-1
900,1,STEP,737137901510,737140529373,2627863,-1
901,1,STEP,737140640072,737143947126,3307054,-1
902,1,STEP,737144065724,737146976084,2910360,-1
903,1,STEP,737147088482,737150226139,3137657,-1
904,1,STEP,737150341037,737153569993,3228956,-1
905,1,STEP,737153681491,737156555451,2873960,-1
906,1,STEP,737156669150,737159645509,2976359,-1
907,1,STEP,737159759707,737163147360,3387653,-1
908,1,STEP,737163224159,737166058020,2833861,-1
909,1,STEP,737166133419,737168797882,2664463,-1
910,1,STEP,737168870281,737171563144,2692863,-1
911,1,STEP,737171636143,737175055895,3419752,-1
912,1,STEP,737175130294,737177564360,2434066,-1
913,1,STEP,737177634959,737180689117,3054158,-1
914,1,STEP,737180760616,737183855273,3094657,-1
915,1,STEP,737183928072,737187163528,3235456,-1
916,1,STEP,737187236327,737189791991,2555664,-1
917,1,STEP,737189863290,737192418155,2554865,-1
918,1,STEP,737192491854,737195541112,3049258,-1
919,1,STEP,737195616710,737198849566,3232856,-1
920,1,STEP,737198923565,737202121720,3198155,-1
921,1,STEP,737202194319,737205520773,3326454,-1
922,1,STEP,737205592272,737208490432,2898160,-1
923,1,STEP,737208568931,737211948084,3379153,-1
924,1,STEP,737212022783,737214677747,2654964,-1
925,1,STEP,737214753145,737218136999,3383854,-1
926,1,STEP,737218211398,737221334154,3122756,-1
927,1,STEP,737221407653,737224080316,2672663,-1
928,1,STEP,737224156815,737227039675,2882860,-1
929,1,STEP,737227112474,737230233031,3120557,-1
930,1,STEP,737230309030,737233423187,3114157,-1
931,1,STEP,737233511686,737236442545,2930859,-1
932,1,STEP,737236518644,737240092795,3574151,-1
933,1,STEP,737240171194,737243731844,3560650,-1
934,1,STEP,737243806943,737247127897,3320954,-1
935,1,STEP,737247203996,737250846946,3642950,-1
936,1,STEP,737250922745,737254511595,3588850,-1
937,1,STEP,737254647593,737258210344,3562751,-1
938,1,STEP,737258344542,737262441785,4097243,-1
939,1,STEP,737262585083,737265513143,2928060,-1
940,1,STEP,737265586042,737269164392,3578350,-1
941,1,STEP,737269240291,737272069152,2828861,-1
942,1,STEP,737272141151,737275390006,3248855,-1
943,1,STEP,737275466005,737279160854,3694849,-1
944,1,STEP,737279238553,737282266211,3027658,-1
945,1,STEP,737282339910,737285945360,3605450,-1
946,1,STEP,737286024159,737289515110,3490951,-1
947,1,STEP,737289591409,737292644867,3053458,-1
948,1,STEP,737292717966,737295068633,2350667,-1
949,1,STEP,737295141632,737298846581,3704949,-1
950,1,STEP,737298923880,737302352432,3428552,-1
951,1,STEP,737302427731,737305414790,2987059,-1
952,1,STEP,737305488389,737308894242,3405853,-1
953,1,STEP,737308969241,737311357308,2388067,-1
954,1,STEP,737311428407,737314675462,3247055,-1
955,1,STEP,737314750461,737317578322,2827861,-1
956,1,STEP,737317650821,737321269870,3619049,-1
957,1,STEP,737321347069,737324607524,3260455,-1
958,1,STEP,737324682723,737327712881,3030158,-1
959,1,STEP,737327788480,737330993836,3205356,-1
960,1,STEP,737331065035,737334369789,3304754,-1
961,1,STEP,737334445188,737337860141,3414953,-1
962,1,STEP,737337953839,737341206394,3252555,-1
963,1,STEP,737341281093,737344437650,3156557,-1
964,1,STEP,737344512949,737347751904,3238955,-1
965,1,STEP,737347827903,737351498952,3671049,-1
966,1,STEP,737351574651,737354955904,3381253,-1
967,1,STEP,737355033203,737358042161,3008958,-1
968,1,STEP,737358119360,737361250817,3131457,-1
969,1,STEP,737361326116,737363986179,2660063,-1
970,1,STEP,737364060478,737366849539,2789061,-1
971,1,STEP,737366927538,737370313891,3386353,-1
972,1,STEP,737370452989,737373602646,3149657,-1
973,1,STEP,737373677245,737376700203,3022958,-1
974,1,STEP,737376775602,737379904359,3128757,-1
975,1,STEP,737379981257,737383147414,3166157,-1
976,1,STEP,737383223213,737386494167,3270954,-1
977,1,STEP,737386571066,737389328028,2756962,-1
978,1,STEP,737389401927,737392605083,3203156,-1
979,1,STEP,737392687582,737396321931,3634349,-1
980,1,STEP,737396399230,737399584486,3185256,-1
981,1,STEP,737399660185,737402626544,2966359,-1
982,1,STEP,737402699443,737405757501,3058058,-1
983,1,STEP,737405833699,737409055855,3222156,-1
984,1,STEP,737409134054,737411989414,2855360,-1
985,1,STEP,737412073513,737414987273,2913760,-1
986,1,STEP,737415068272,737417823833,2755561,-1
987,1,STEP,737417909032,737421275186,3366154,-1
988,1,STEP,737421351585,737424500241,3148656,-1
989,1,STEP,737424574840,737427563399,2988559,-1
990,1,STEP,737427639898,737430196362,2556464,-1
991,1,STEP,737430270461,737433436117,3165656,-1
992,1,STEP,737433536716,737436627473,3090757,-1
993,1,STEP,737436714672,737439783429,3068757,-1
994,1,STEP,737439868528,737442746788,2878260,-1
995,1,STEP,737442835387,737446465437,3630050,-1
996,1,STEP,737446557836,737449619193,3061357,-1
997,1,STEP,737449712192,737453062345,3350153,-1
998,1,STEP,737453174544,737456328800,3154256,-1
999,1,STEP,737456404999,737459578455,3173456,-1
