Gen,Resource,Stamp,TimeStamp_Start,TimeStamp_End,Duration,Indiv_id
0,1,FirstEvaluation,874413371047,875207274511,793903464,-1
0,1,STEP,875207447109,875213326446,5879337,-1
1,1,STEP,875213401445,875217898297,4496852,-1
2,1,STEP,875217967496,875222870344,4902848,-1
3,1,STEP,875222944143,875227152998,4208855,-1
4,1,STEP,875227224997,875230691560,3466563,-1
5,1,STEP,875230777659,875235384309,4606650,-1
6,1,STEP,875235454808,875239835861,4381053,-1
7,1,STEP,875239905661,875244154415,4248754,-1
8,1,STEP,875244231914,875247994274,3762360,-1
9,1,STEP,875248092772,875253007620,4914848,-1
10,1,STEP,875253106319,875256718180,3611861,-1
11,1,STEP,875256814979,875261622927,4807948,-1
12,1,STEP,875261721626,875266719872,4998246,-1
13,1,STEP,875266814871,875271009526,4194655,-1
14,1,STEP,875271109025,875275297080,4188055,-1
15,1,STEP,875275397979,875278677544,3279565,-1
16,1,STEP,875278779843,875282872699,4092856,-1
17,1,STEP,875282975697,875287125053,4149356,-1
18,1,STEP,875287230452,875290830213,3599761,-1
19,1,STEP,875290932312,875294084278,3151966,-1
20,1,STEP,875294177477,875298393532,4216055,-1
21,1,STEP,875298505130,875302063092,3557962,-1
22,1,STEP,875302167191,875305211458,3044267,-1
23,1,STEP,875305310957,875309244315,3933358,-1
24,1,STEP,875309346814,875313610268,4263454,-1
25,1,STEP,875313706067,875317665524,3959457,-1
26,1,STEP,875317765023,875321964678,4199655,-1
27,1,STEP,875322069577,875326208333,4138756,-1
28,1,STEP,875326310432,875329888193,3577761,-1
29,1,STEP,875329983592,875334752441,4768849,-1
30,1,STEP,875334839740,875338592799,3753059,-1
31,1,STEP,875338665299,875342432858,3767559,-1
32,1,STEP,875342509457,875346312716,3803259,-1
33,1,STEP,875346386416,875349685380,3298964,-1
34,1,STEP,875349755879,875353300441,3544562,-1
35,1,STEP,875353375141,875356600006,3224865,-1
36,1,STEP,875356675805,875360151468,3475663,-1
37,1,STEP,875360224467,875363318734,3094267,-1
38,1,STEP,875363388433,875366230902,2842469,-1
39,1,STEP,875366300102,875369412768,3112666,-1
40,1,STEP,875369481567,875372744232,3262665,-1
41,1,STEP,875372812632,875376073497,3260865,-1
42,1,STEP,875376141796,875379939255,3797459,-1
43,1,STEP,875380020154,875383072621,3052467,-1
44,1,STEP,875383156720,875386227487,3070767,-1
45,1,STEP,875386308286,875389713050,3404764,-1
46,1,STEP,875389800749,875392855516,3054767,-1
47,1,STEP,875392939915,875396006582,3066667,-1
48,1,STEP,875396088381,875399170848,3082467,-1
49,1,STEP,875399240747,875401989818,2749071,-1
50,1,STEP,875402057417,875405302882,3245465,-1
51,1,STEP,875405367682,875408678646,3310964,-1
52,1,STEP,875408798545,875412373706,3575161,-1
53,1,STEP,875412447605,875415403574,2955969,-1
54,1,STEP,875415490373,875418986135,3495762,-1
55,1,STEP,875419057534,875423558686,4501152,-1
56,1,STEP,875423651385,875427268346,3616961,-1
57,1,STEP,875427340645,875430106816,2766171,-1
58,1,STEP,875430176315,875432956585,2780270,-1
59,1,STEP,875433027084,875435643356,2616272,-1
60,1,STEP,875435713655,875438459026,2745371,-1
61,1,STEP,875438528625,875441730391,3201766,-1
62,1,STEP,875441799690,875444758658,2958968,-1
63,1,STEP,875444829257,875447964424,3135167,-1
64,1,STEP,875448035323,875451838982,3803659,-1
65,1,STEP,875451928781,875455580742,3651961,-1
66,1,STEP,875455652041,875458112614,2460573,-1
67,1,STEP,875458183814,875461114982,2931168,-1
68,1,STEP,875461183681,875464012251,2828570,-1
69,1,STEP,875464081050,875466712922,2631872,-1
70,1,STEP,875466781521,875469371693,2590172,-1
71,1,STEP,875469443293,875472623458,3180165,-1
72,1,STEP,875472692758,875475882823,3190065,-1
73,1,STEP,875475953723,875479359886,3406163,-1
74,1,STEP,875479428985,875482560952,3131967,-1
75,1,STEP,875482629151,875485673918,3044767,-1
76,1,STEP,875485743817,875488457288,2713471,-1
77,1,STEP,875488525087,875491413656,2888569,-1
78,1,STEP,875491482956,875494381225,2898269,-1
79,1,STEP,875494450724,875497176794,2726070,-1
80,1,STEP,875497246094,875500259661,3013567,-1
81,1,STEP,875500366960,875503184330,2817370,-1
82,1,STEP,875503294329,875506342696,3048367,-1
83,1,STEP,875506448995,875509320064,2871069,-1
84,1,STEP,875509425263,875512508430,3083167,-1
85,1,STEP,875512626228,875515541497,2915269,-1
86,1,STEP,875515654196,875518726863,3072667,-1
87,1,STEP,875518837862,875521910229,3072367,-1
88,1,STEP,875522027727,875524946196,2918469,-1
89,1,STEP,875525057195,875527861665,2804470,-1
90,1,STEP,875527971563,875531218628,3247065,-1
91,1,STEP,875531329227,875534717691,3388464,-1
92,1,STEP,875534828590,875538080455,3251865,-1
93,1,STEP,875538190753,875540962024,2771271,-1
94,1,STEP,875541071523,875543897492,2825969,-1
95,1,STEP,875544004191,875547265356,3261165,-1
96,1,STEP,875547370455,875550258524,2888069,-1
97,1,STEP,875550369523,875553211692,2842169,-1
98,1,STEP,875553320391,875556158260,2837869,-1
99,1,STEP,875556265259,875559366426,3101167,-1
100,1,STEP,875559477825,875562100096,2622271,-1
101,1,STEP,875562208195,875565087564,2879369,-1
102,1,STEP,875565192763,875568197331,3004568,-1
103,1,STEP,875568307330,875571072400,2765070,-1
104,1,STEP,875571182999,875573884870,2701871,-1
105,1,STEP,875573990569,875577293833,3303264,-1
106,1,STEP,875577404332,875580475599,3071267,-1
107,1,STEP,875580585398,875583484467,2899069,-1
108,1,STEP,875583594465,875586960029,3365564,-1
109,1,STEP,875587075128,875590134895,3059767,-1
110,1,STEP,875590247194,875593285461,3038267,-1
111,1,STEP,875593395160,875596562926,3167766,-1
112,1,STEP,875596679925,875599522294,2842369,-1
113,1,STEP,875599634993,875602398963,2763970,-1
114,1,STEP,875602513162,875605640528,3127366,-1
115,1,STEP,875605753327,875608559297,2805970,-1
116,1,STEP,875608672896,875612009760,3336864,-1
117,1,STEP,875612124459,875615346124,3221665,-1
118,1,STEP,875615459123,875618919186,3460063,-1
119,1,STEP,875619034584,875622521047,3486463,-1
120,1,STEP,875622635846,875626087608,3451762,-1
121,1,STEP,875626201207,875629513272,3312065,-1
122,1,STEP,875629626470,875632869036,3242566,-1
123,1,STEP,875632981934,875636024102,3042168,-1
124,1,STEP,875636138900,875639341966,3203066,-1
125,1,STEP,875639455665,875642317334,2861669,-1
126,1,STEP,875642431933,875645478500,3046567,-1
127,1,STEP,875645592999,875649076761,3483762,-1
128,1,STEP,875649216960,875652474825,3257865,-1
129,1,STEP,875652587524,875655613291,3025767,-1
130,1,STEP,875655727590,875658546559,2818969,-1
131,1,STEP,875658658858,875661610327,2951469,-1
132,1,STEP,875661724125,875664553095,2828970,-1
133,1,STEP,875664668994,875667651362,2982368,-1
134,1,STEP,875667767260,875671053225,3285965,-1
135,1,STEP,875671165924,875674229691,3063767,-1
136,1,STEP,875674342790,875677061360,2718570,-1
137,1,STEP,875677169859,875680738021,3568162,-1
138,1,STEP,875680853120,875683828588,2975468,-1
139,1,STEP,875683938386,875686872855,2934469,-1
140,1,STEP,875686985154,875690110820,3125666,-1
141,1,STEP,875690223819,875693431984,3208165,-1
142,1,STEP,875693541983,875697232844,3690861,-1
143,1,STEP,875697345742,875700437309,3091567,-1
144,1,STEP,875700550208,875702938182,2387974,-1
145,1,STEP,875703047881,875706780141,3732260,-1
146,1,STEP,875706895140,875709655110,2759970,-1
147,1,STEP,875709765909,875712554179,2788270,-1
148,1,STEP,875712668278,875715538347,2870069,-1
149,1,STEP,875715649446,875719040409,3390963,-1
150,1,STEP,875719154608,875722183475,3028867,-1
151,1,STEP,875722294374,875725668138,3373764,-1
152,1,STEP,875725779437,875728895503,3116066,-1
153,1,STEP,875729004102,875731675773,2671671,-1
154,1,STEP,875731787472,875734936338,3148866,-1
155,1,STEP,875735050737,875738263402,3212665,-1
156,1,STEP,875738375401,875740995073,2619672,-1
157,1,STEP,875741102572,875744197639,3095067,-1
158,1,STEP,875744310237,875747824400,3514163,-1
159,1,STEP,875747937798,875751054565,3116767,-1
160,1,STEP,875751170864,875754585827,3414963,-1
161,1,STEP,875754700526,875757881891,3181365,-1
162,1,STEP,875758002790,875761061057,3058267,-1
163,1,STEP,875761170356,875763995726,2825370,-1
164,1,STEP,875764105925,875767286490,3180565,-1
165,1,STEP,875767398289,875770497556,3099267,-1
166,1,STEP,875770611155,875773977318,3366163,-1
167,1,STEP,875774090517,875777261883,3171366,-1
168,1,STEP,875777374082,875780591147,3217065,-1
169,1,STEP,875780702446,875783545116,2842670,-1
170,1,STEP,875783657614,875786549883,2892269,-1
171,1,STEP,875786667782,875789702849,3035067,-1
172,1,STEP,875789813748,875792474220,2660472,-1
173,1,STEP,875792583718,875795710185,3126467,-1
174,1,STEP,875795823084,875798973350,3150266,-1
175,1,STEP,875799084449,875801859919,2775470,-1
176,1,STEP,875801987917,875805234482,3246565,-1
177,1,STEP,875805345181,875808491047,3145866,-1
178,1,STEP,875808605346,875811223618,2618272,-1
179,1,STEP,875811335617,875814798980,3463363,-1
180,1,STEP,875814913778,875817606449,2692671,-1
181,1,STEP,875817716648,875820432019,2715371,-1
182,1,STEP,875820543318,875823331288,2787970,-1
183,1,STEP,875823442287,875826399855,2957568,-1
184,1,STEP,875826514754,875829861018,3346264,-1
185,1,STEP,875829990416,875833263981,3273565,-1
186,1,STEP,875833380480,875835888753,2508273,-1
187,1,STEP,875835998352,875838999419,3001067,-1
188,1,STEP,875839110718,875842078886,2968168,-1
189,1,STEP,875842189985,875844762957,2572972,-1
190,1,STEP,875844872756,875847592627,2719871,-1
191,1,STEP,875847701326,875850709893,3008567,-1
192,1,STEP,875850822392,875853356765,2534373,-1
193,1,STEP,875853465564,875856323033,2857469,-1
194,1,STEP,875856435032,875859211402,2776370,-1
195,1,STEP,875859325101,875862582066,3256965,-1
196,1,STEP,875862655865,875866164827,3508962,-1
197,1,STEP,875866236827,875868912798,2675971,-1
198,1,STEP,875868979797,875871936165,2956368,-1
199,1,STEP,875872005964,875875095931,3089967,-1
200,1,STEP,875875164931,875877995300,2830369,-1
201,1,STEP,875878116399,875881413664,3297265,-1
202,1,STEP,875881527662,875885016526,3488864,-1
203,1,STEP,875885133424,875887993994,2860570,-1
204,1,STEP,875888106593,875891358059,3251466,-1
205,1,STEP,875891472858,875894442426,2969568,-1
206,1,STEP,875894555525,875898262886,3707361,-1
207,1,STEP,875898376085,875901423153,3047068,-1
208,1,STEP,875901534852,875904406922,2872070,-1
209,1,STEP,875904518220,875907636787,3118567,-1
210,1,STEP,875907749386,875910277160,2527774,-1
211,1,STEP,875910389059,875913512026,3122967,-1
212,1,STEP,875913631424,875916811791,3180367,-1
213,1,STEP,875916924690,875920487952,3563262,-1
214,1,STEP,875920602151,875924346512,3744361,-1
215,1,STEP,875924461610,875927305680,2844070,-1
216,1,STEP,875927418379,875930881943,3463564,-1
217,1,STEP,875930995042,875934062209,3067167,-1
218,1,STEP,875934175408,875937451474,3276066,-1
219,1,STEP,875937564272,875940459542,2895270,-1
220,1,STEP,875940572141,875943939305,3367164,-1
221,1,STEP,875944053104,875947040073,2986969,-1
222,1,STEP,875947152671,875950782633,3629962,-1
223,1,STEP,875950896632,875954533594,3636962,-1
224,1,STEP,875954651092,875957792359,3141267,-1
225,1,STEP,875957915358,875961068525,3153167,-1
226,1,STEP,875961182224,875964111893,2929669,-1
227,1,STEP,875964226192,875967245660,3019468,-1
228,1,STEP,875967361159,875970073730,2712571,-1
229,1,STEP,875970186929,875973205097,3018168,-1
230,1,STEP,875973320896,875976619461,3298565,-1
231,1,STEP,875976733660,875979807927,3074267,-1
232,1,STEP,875979922926,875982450300,2527374,-1
233,1,STEP,875982564198,875985677366,3113168,-1
234,1,STEP,875985794664,875988521236,2726572,-1
235,1,STEP,875988635335,875992496494,3861159,-1
236,1,STEP,875992614793,875995509562,2894769,-1
237,1,STEP,875995624061,875999126024,3501963,-1
238,1,STEP,875999243023,876001930095,2687072,-1
239,1,STEP,876002042693,876005192660,3149967,-1
240,1,STEP,876005309159,876008594124,3284965,-1
241,1,STEP,876008708823,876011920489,3211666,-1
242,1,STEP,876012036388,876015027257,2990869,-1
243,1,STEP,876015142755,876018329022,3186267,-1
244,1,STEP,876018446321,876021753986,3307665,-1
245,1,STEP,876021880484,876025626045,3745561,-1
246,1,STEP,876025745344,876028144718,2399374,-1
247,1,STEP,876028259517,876030977489,2717972,-1
248,1,STEP,876031092887,876034048856,2955969,-1
249,1,STEP,876034164855,876037229423,3064568,-1
250,1,STEP,876037344022,876041033883,3689861,-1
251,1,STEP,876041151082,876044325848,3174766,-1
252,1,STEP,876044436147,876047673613,3237466,-1
253,1,STEP,876047787612,876050471083,2683471,-1
254,1,STEP,876050584482,876053667850,3083368,-1
255,1,STEP,876053779949,876056885716,3105767,-1
256,1,STEP,876057045114,876060123582,3078468,-1
257,1,STEP,876060238081,876063599645,3361564,-1
258,1,STEP,876063715244,876066371216,2655972,-1
259,1,STEP,876066485015,876069723581,3238566,-1
260,1,STEP,876069836679,876073427242,3590563,-1
261,1,STEP,876073542440,876076541409,2998969,-1
262,1,STEP,876076656808,876079600477,2943669,-1
263,1,STEP,876079713875,876083616934,3903059,-1
264,1,STEP,876083732633,876086803001,3070368,-1
265,1,STEP,876086917200,876089437373,2520173,-1
266,1,STEP,876089551172,876092735838,3184666,-1
267,1,STEP,876092850937,876096305501,3454564,-1
268,1,STEP,876096422699,876098882674,2459975,-1
269,1,STEP,876098995572,876102085440,3089868,-1
270,1,STEP,876102207439,876105585303,3377864,-1
271,1,STEP,876105700602,876109079766,3379164,-1
272,1,STEP,876109195565,876112376931,3181366,-1
273,1,STEP,876112492530,876115016704,2524174,-1
274,1,STEP,876115133402,876117813474,2680072,-1
275,1,STEP,876117937473,876121244038,3306565,-1
276,1,STEP,876121360737,876124627902,3267165,-1
277,1,STEP,876124748901,876127680870,2931969,-1
278,1,STEP,876127796469,876130844737,3048268,-1
279,1,STEP,876130960036,876134050103,3090067,-1
280,1,STEP,876134166202,876137341469,3175267,-1
281,1,STEP,876137457767,876140157039,2699272,-1
282,1,STEP,876140271238,876143163607,2892369,-1
283,1,STEP,876143280506,876146201775,2921269,-1
284,1,STEP,876146318374,876149454241,3135867,-1
285,1,STEP,876149569940,876152831105,3261165,-1
286,1,STEP,876152949604,876156188170,3238566,-1
287,1,STEP,876156301269,876159313937,3012668,-1
288,1,STEP,876159423036,876162767101,3344065,-1
289,1,STEP,876162882800,876165417673,2534873,-1
290,1,STEP,876165534272,876168399742,2865470,-1
291,1,STEP,876168488241,876172187802,3699561,-1
292,1,STEP,876172322000,876177475646,5153646,-1
293,1,STEP,876177623744,876181072008,3448264,-1
294,1,STEP,876181185907,876184367273,3181366,-1
295,1,STEP,876184482072,876187915736,3433664,-1
296,1,STEP,876188028835,876190818705,2789870,-1
297,1,STEP,876190932604,876193936673,3004069,-1
298,1,STEP,876194054171,876197172539,3118368,-1
299,1,STEP,876197285337,876200101108,2815771,-1
300,1,STEP,876200213907,876203308874,3094967,-1
301,1,STEP,876203419473,876205929046,2509573,-1
302,1,STEP,876206041745,876209514109,3472364,-1
303,1,STEP,876209599508,876212824574,3225066,-1
304,1,STEP,876212911573,876216085639,3174066,-1
305,1,STEP,876216163239,876219220806,3057567,-1
306,1,STEP,876219295406,876222581871,3286465,-1
307,1,STEP,876222656470,876225360642,2704172,-1
308,1,STEP,876225432741,876228369410,2936669,-1
309,1,STEP,876228442109,876230898183,2456074,-1
310,1,STEP,876230971583,876234348247,3376664,-1
311,1,STEP,876234423346,876237587313,3163967,-1
312,1,STEP,876237660312,876240802979,3142667,-1
313,1,STEP,876240876978,876243861847,2984869,-1
314,1,STEP,876243936946,876246799516,2862570,-1
315,1,STEP,876246871115,876249813984,2942869,-1
316,1,STEP,876249899283,876252673754,2774471,-1
317,1,STEP,876252745153,876255465725,2720572,-1
318,1,STEP,876255552324,876258626191,3073867,-1
319,1,STEP,876258699091,876261893657,3194566,-1
320,1,STEP,876261968256,876264953925,2985669,-1
321,1,STEP,876265025924,876268307589,3281665,-1
322,1,STEP,876268381389,876271382757,3001368,-1
323,1,STEP,876271455956,876274765321,3309365,-1
324,1,STEP,876274840821,876277524092,2683271,-1
325,1,STEP,876277595792,876280758458,3162666,-1
326,1,STEP,876280831558,876284192322,3360764,-1
327,1,STEP,876284268021,876287144691,2876670,-1
328,1,STEP,876287217790,876289755464,2537674,-1
329,1,STEP,876289826763,876292907530,3080767,-1
330,1,STEP,876292982830,876296127597,3144767,-1
331,1,STEP,876296201296,876299248264,3046968,-1
332,1,STEP,876299324463,876301768837,2444374,-1
333,1,STEP,876301842336,876305001303,3158967,-1
334,1,STEP,876305075202,876308059871,2984669,-1
335,1,STEP,876308134170,876310882541,2748371,-1
336,1,STEP,876310982440,876314056308,3073868,-1
337,1,STEP,876314130107,876317042976,2912869,-1
338,1,STEP,876317115575,876320214443,3098868,-1
339,1,STEP,876320288842,876323136512,2847670,-1
340,1,STEP,876323210311,876326479777,3269466,-1
341,1,STEP,876326555876,876329732143,3176267,-1
342,1,STEP,876329813342,876333031208,3217866,-1
343,1,STEP,876333106107,876336337673,3231566,-1
344,1,STEP,876336412772,876339564939,3152167,-1
345,1,STEP,876339639138,876342489008,2849870,-1
346,1,STEP,876342562308,876345482177,2919869,-1
347,1,STEP,876345556376,876348573244,3016868,-1
348,1,STEP,876348647843,876352000108,3352265,-1
349,1,STEP,876352075307,876355323973,3248666,-1
350,1,STEP,876355400572,876358419741,3019169,-1
351,1,STEP,876358493640,876361487508,2993868,-1
352,1,STEP,876361562507,876364796873,3234366,-1
353,1,STEP,876364872373,876367847041,2974668,-1
354,1,STEP,876367921840,876371036608,3114768,-1
355,1,STEP,876371113107,876374791668,3678561,-1
356,1,STEP,876374868867,876377891935,3023068,-1
357,1,STEP,876377963735,876380934703,2970968,-1
358,1,STEP,876381008203,876383797573,2789370,-1
359,1,STEP,876383871673,876386903141,3031468,-1
360,1,STEP,876386976440,876390368504,3392064,-1
361,1,STEP,876390442803,876393336973,2894170,-1
362,1,STEP,876393408672,876396012145,2603473,-1
363,1,STEP,876396090144,876398585218,2495074,-1
364,1,STEP,876398657517,876401545586,2888069,-1
365,1,STEP,876401616186,876404708853,3092667,-1
366,1,STEP,876404783752,876408114517,3330765,-1
367,1,STEP,876408202716,876411309684,3106968,-1
368,1,STEP,876411383683,876414249053,2865370,-1
369,1,STEP,876414325352,876417335120,3009768,-1
370,1,STEP,876417409919,876419906893,2496974,-1
371,1,STEP,876419983092,876423209558,3226466,-1
372,1,STEP,876423285957,876426555923,3269966,-1
373,1,STEP,876426631322,876429684290,3052968,-1
374,1,STEP,876429766489,876432856857,3090368,-1
375,1,STEP,876432939156,876435895225,2956069,-1
376,1,STEP,876435982024,876438670995,2688971,-1
377,1,STEP,876438755995,876441660264,2904269,-1
378,1,STEP,876441743963,876444446035,2702072,-1
379,1,STEP,876444528534,876447423003,2894469,-1
380,1,STEP,876447517002,876450575970,3058968,-1
381,1,STEP,876450660969,876453197942,2536973,-1
382,1,STEP,876453286242,876456592507,3306265,-1
383,1,STEP,876456676906,876459568775,2891869,-1
384,1,STEP,876459654874,876462738042,3083168,-1
385,1,STEP,876462822841,876465733510,2910669,-1
386,1,STEP,876465816410,876469166674,3350264,-1
387,1,STEP,876469258173,876472553539,3295366,-1
388,1,STEP,876472635238,876475739105,3103867,-1
389,1,STEP,876475823104,876478674074,2850970,-1
390,1,STEP,876478758973,876481769642,3010669,-1
391,1,STEP,876481854141,876484848509,2994368,-1
392,1,STEP,876484939808,876488141775,3201967,-1
393,1,STEP,876488232174,876491301541,3069367,-1
394,1,STEP,876491391240,876494432008,3040768,-1
395,1,STEP,876494515207,876497861172,3345965,-1
396,1,STEP,876497965971,876501027539,3061568,-1
397,1,STEP,876501102938,876503833909,2730971,-1
398,1,STEP,876503906009,876506882577,2976568,-1
399,1,STEP,876506955276,876510451740,3496464,-1
400,1,STEP,876510525439,876513457808,2932369,-1
401,1,STEP,876513530807,876516267178,2736371,-1
402,1,STEP,876516340978,876518703853,2362875,-1
403,1,STEP,876518776152,876521827220,3051068,-1
404,1,STEP,876521911319,876524466292,2554973,-1
405,1,STEP,876524537591,876527413161,2875570,-1
406,1,STEP,876527486760,876530214431,2727671,-1
407,1,STEP,876530287031,876533435198,3148167,-1
408,1,STEP,876533507697,876536738463,3230766,-1
409,1,STEP,876536808862,876540211126,3402264,-1
410,1,STEP,876540280825,876543103696,2822871,-1
411,1,STEP,876543174895,876546447061,3272166,-1
412,1,STEP,876546520160,876549169232,2649072,-1
413,1,STEP,876549240531,876552675795,3435264,-1
414,1,STEP,876552749794,876555601564,2851770,-1
415,1,STEP,876555673563,876558052138,2378575,-1
416,1,STEP,876558124638,876561184405,3059767,-1
417,1,STEP,876561255705,876563945676,2689971,-1
418,1,STEP,876564018875,876567024544,3005669,-1
419,1,STEP,876567097143,876570104911,3007768,-1
420,1,STEP,876570177311,876572855182,2677871,-1
421,1,STEP,876572925282,876575712752,2787470,-1
422,1,STEP,876575784652,876579084817,3300165,-1
423,1,STEP,876579158316,876582218884,3060568,-1
424,1,STEP,876582291383,876584998155,2706772,-1
425,1,STEP,876585067454,876588020923,2953469,-1
426,1,STEP,876588094822,876591333688,3238866,-1
427,1,STEP,876591414587,876593935860,2521273,-1
428,1,STEP,876594005560,876597559222,3553662,-1
429,1,STEP,876597632022,876600699789,3067767,-1
430,1,STEP,876600774888,876603564259,2789371,-1
431,1,STEP,876603637058,876606697526,3060468,-1
432,1,STEP,876606770825,876609485597,2714772,-1
433,1,STEP,876609556596,876613044959,3488363,-1
434,1,STEP,876613120458,876615814330,2693872,-1
435,1,STEP,876615887629,876619199794,3312165,-1
436,1,STEP,876619273294,876622104664,2831370,-1
437,1,STEP,876622178563,876625281930,3103367,-1
438,1,STEP,876625354530,876628794493,3439963,-1
439,1,STEP,876628869093,876632165658,3296565,-1
440,1,STEP,876632248857,876635362024,3113167,-1
441,1,STEP,876635452323,876638121195,2668872,-1
442,1,STEP,876638205194,876641843256,3638062,-1
443,1,STEP,876641942355,876645689315,3746960,-1
444,1,STEP,876645779815,876649011180,3231365,-1
445,1,STEP,876649098580,876651665753,2567173,-1
446,1,STEP,876651745352,876655152116,3406764,-1
447,1,STEP,876655236315,876657977986,2741671,-1
448,1,STEP,876658057485,876660843556,2786071,-1
449,1,STEP,876660924155,876663720426,2796271,-1
450,1,STEP,876663801825,876666629295,2827470,-1
451,1,STEP,876666712294,876669668863,2956569,-1
452,1,STEP,876669750562,876672837530,3086968,-1
453,1,STEP,876672921629,876675923197,3001568,-1
454,1,STEP,876676007096,876679022464,3015368,-1
455,1,STEP,876679104464,876682306530,3202066,-1
456,1,STEP,876682389129,876685305498,2916369,-1
457,1,STEP,876685385897,876688330966,2945069,-1
458,1,STEP,876688415066,876691366234,2951168,-1
459,1,STEP,876691448234,876694660100,3211866,-1
460,1,STEP,876694744399,876697760767,3016368,-1
461,1,STEP,876697843466,876700892434,3048968,-1
462,1,STEP,876700976033,876703915902,2939869,-1
463,1,STEP,876703997001,876707171168,3174167,-1
464,1,STEP,876707254667,876710467133,3212466,-1
465,1,STEP,876710549832,876714037296,3487464,-1
466,1,STEP,876714127195,876717383360,3256165,-1
467,1,STEP,876717469260,876720745925,3276665,-1
468,1,STEP,876720830824,876724190589,3359765,-1
469,1,STEP,876724274988,876727625653,3350665,-1
470,1,STEP,876727709952,876731252414,3542462,-1
471,1,STEP,876731337214,876734250983,2913769,-1
472,1,STEP,876734338082,876737929944,3591862,-1
473,1,STEP,876738014643,876741300409,3285766,-1
474,1,STEP,876741382808,876745169868,3787060,-1
475,1,STEP,876745257567,876748202936,2945369,-1
476,1,STEP,876748290035,876751392502,3102467,-1
477,1,STEP,876751479501,876754769867,3290366,-1
478,1,STEP,876754858566,876758478528,3619962,-1
479,1,STEP,876758562927,876761688994,3126067,-1
480,1,STEP,876761773893,876764800461,3026568,-1
481,1,STEP,876764888760,876768127626,3238866,-1
482,1,STEP,876768213125,876770794998,2581873,-1
483,1,STEP,876770887697,876773923965,3036268,-1
484,1,STEP,876774009464,876777049232,3039768,-1
485,1,STEP,876777132631,876780653494,3520863,-1
486,1,STEP,876780741493,876783720662,2979169,-1
487,1,STEP,876783806961,876786756630,2949669,-1
488,1,STEP,876786842629,876790366292,3523663,-1
489,1,STEP,876790453391,876793764756,3311365,-1
490,1,STEP,876793851855,876796856624,3004769,-1
491,1,STEP,876796948923,876799887692,2938769,-1
492,1,STEP,876799973491,876803581053,3607562,-1
493,1,STEP,876803668852,876806492622,2823770,-1
494,1,STEP,876806577021,876809372492,2795471,-1
495,1,STEP,876809458791,876812215062,2756271,-1
496,1,STEP,876812298061,876815344429,3046368,-1
497,1,STEP,876815425128,876818704794,3279666,-1
498,1,STEP,876818793693,876822748251,3954558,-1
499,1,STEP,876822836050,876826106616,3270566,-1
500,1,STEP,876826191615,876829567979,3376364,-1
501,1,STEP,876829659778,876832511348,2851570,-1
502,1,STEP,876832599047,876835837313,3238266,-1
503,1,STEP,876835924412,876839166378,3241966,-1
504,1,STEP,876839256077,876842376444,3120367,-1
505,1,STEP,876842463743,876845936407,3472664,-1
506,1,STEP,876846092905,876849575768,3482863,-1
507,1,STEP,876849651068,876852860134,3209066,-1
508,1,STEP,876852936333,876856061900,3125567,-1
509,1,STEP,876856135999,876859104568,2968569,-1
510,1,STEP,876859179867,876862148136,2968269,-1
511,1,STEP,876862221635,876865305403,3083768,-1
512,1,STEP,876865414302,876868452370,3038068,-1
513,1,STEP,876868526969,876871293840,2766871,-1
514,1,STEP,876871367939,876874575305,3207366,-1
515,1,STEP,876874651304,876877558474,2907170,-1
516,1,STEP,876877631773,876880839739,3207966,-1
517,1,STEP,876880912638,876883860907,2948269,-1
518,1,STEP,876883928907,876887256272,3327365,-1
519,1,STEP,876887329771,876890413038,3083267,-1
520,1,STEP,876890484838,876893816603,3331765,-1
521,1,STEP,876893898802,876897122468,3223666,-1
522,1,STEP,876897196667,876900410633,3213966,-1
523,1,STEP,876900484332,876903728898,3244566,-1
524,1,STEP,876903801797,876907052963,3251166,-1
525,1,STEP,876907126962,876910561926,3434964,-1
526,1,STEP,876910635525,876913685493,3049968,-1
527,1,STEP,876913756993,876916591863,2834870,-1
528,1,STEP,876916664762,876919441533,2776771,-1
529,1,STEP,876919512732,876922798097,3285365,-1
530,1,STEP,876922870697,876926052563,3181866,-1
531,1,STEP,876926126662,876929453427,3326765,-1
532,1,STEP,876929526827,876932299997,2773170,-1
533,1,STEP,876932372997,876935616962,3243965,-1
534,1,STEP,876935690662,876938465932,2775270,-1
535,1,STEP,876938538432,876941720598,3182166,-1
536,1,STEP,876941793697,876944660467,2866770,-1
537,1,STEP,876944732866,876947384138,2651272,-1
538,1,STEP,876947456738,876951268498,3811760,-1
539,1,STEP,876951344297,876953834671,2490374,-1
540,1,STEP,876953914570,876956797839,2883269,-1
541,1,STEP,876956871039,876960239603,3368564,-1
542,1,STEP,876960313302,876962581878,2268576,-1
543,1,STEP,876962653178,876965722445,3069267,-1
544,1,STEP,876965794845,876968712514,2917669,-1
545,1,STEP,876968782813,876972155878,3373065,-1
546,1,STEP,876972230577,876974960648,2730071,-1
547,1,STEP,876975034147,876978336013,3301866,-1
548,1,STEP,876978410712,876981843076,3432364,-1
549,1,STEP,876981926175,876984995142,3068967,-1
550,1,STEP,876985068142,876988240108,3171966,-1
551,1,STEP,876988314307,876991295776,2981469,-1
552,1,STEP,876991369775,876994226845,2857070,-1
553,1,STEP,876994300244,876997438511,3138267,-1
554,1,STEP,876997512011,877000911475,3399464,-1
555,1,STEP,877000986474,877004196540,3210066,-1
556,1,STEP,877004272139,877007124709,2852570,-1
557,1,STEP,877007199509,877009971079,2771570,-1
558,1,STEP,877010045379,877013412643,3367264,-1
559,1,STEP,877013486642,877016328912,2842270,-1
560,1,STEP,877016403612,877019053284,2649672,-1
561,1,STEP,877019126283,877021674056,2547773,-1
562,1,STEP,877021745755,877024388928,2643173,-1
563,1,STEP,877024458627,877027681893,3223266,-1
564,1,STEP,877027756892,877031247955,3491063,-1
565,1,STEP,877031322955,877034360623,3037668,-1
566,1,STEP,877034433822,877037346591,2912769,-1
567,1,STEP,877037419190,877040681556,3262366,-1
568,1,STEP,877040756255,877043563926,2807671,-1
569,1,STEP,877043631825,877046760892,3129067,-1
570,1,STEP,877046835791,877050189856,3354065,-1
571,1,STEP,877050264755,877053592220,3327465,-1
572,1,STEP,877053665519,877056532289,2866770,-1
573,1,STEP,877056605488,877059604757,2999269,-1
574,1,STEP,877059678056,877062773123,3095067,-1
575,1,STEP,877062846723,877066241587,3394864,-1
576,1,STEP,877066318986,877069148856,2829870,-1
577,1,STEP,877069221955,877072267323,3045368,-1
578,1,STEP,877072355922,877075628288,3272366,-1
579,1,STEP,877075703187,877078859454,3156267,-1
580,1,STEP,877078935153,877082167319,3232166,-1
581,1,STEP,877082243018,877085210487,2967469,-1
582,1,STEP,877085295986,877089122946,3826960,-1
583,1,STEP,877089198845,877092152114,2953269,-1
584,1,STEP,877092237013,877095885375,3648362,-1
585,1,STEP,877095977574,877099127241,3149667,-1
586,1,STEP,877099203840,877102708503,3504663,-1
587,1,STEP,877102786302,877106011568,3225266,-1
588,1,STEP,877106087667,877109504531,3416864,-1
589,1,STEP,877109577931,877112508300,2930369,-1
590,1,STEP,877112580199,877115822265,3242066,-1
591,1,STEP,877115896064,877119122530,3226466,-1
592,1,STEP,877119196229,877123332986,4136757,-1
593,1,STEP,877123451284,877127085446,3634162,-1
594,1,STEP,877127227045,877131102904,3875859,-1
595,1,STEP,877131181903,877134075873,2893970,-1
596,1,STEP,877134151972,877136824444,2672472,-1
597,1,STEP,877136900743,877139762713,2861970,-1
598,1,STEP,877139844612,877142691082,2846470,-1
599,1,STEP,877142765381,877146160045,3394664,-1
600,1,STEP,877146234944,877149403811,3168867,-1
601,1,STEP,877149477810,877152828375,3350565,-1
602,1,STEP,877152905474,877155960442,3054968,-1
603,1,STEP,877156035041,877159160108,3125067,-1
604,1,STEP,877159235908,877162044278,2808370,-1
605,1,STEP,877162117577,877165820138,3702561,-1
606,1,STEP,877165914537,877168875606,2961069,-1
607,1,STEP,877168950005,877172189271,3239266,-1
608,1,STEP,877172274970,877175391937,3116967,-1
609,1,STEP,877175467637,877178584504,3116867,-1
610,1,STEP,877178661703,877181807170,3145467,-1
611,1,STEP,877181900869,877184667240,2766371,-1
612,1,STEP,877184741739,877187695608,2953869,-1
613,1,STEP,877187770207,877190522478,2752271,-1
614,1,STEP,877190598677,877193976842,3378165,-1
615,1,STEP,877194051641,877197076809,3025168,-1
616,1,STEP,877197150608,877200016078,2865470,-1
617,1,STEP,877200090877,877202709550,2618673,-1
618,1,STEP,877202786049,877205943116,3157067,-1
619,1,STEP,877206029415,877209248481,3219066,-1
620,1,STEP,877209321080,877212476847,3155767,-1
621,1,STEP,877212552246,877215406016,2853770,-1
622,1,STEP,877215480815,877218388485,2907670,-1
623,1,STEP,877218464684,877221632051,3167367,-1
624,1,STEP,877221708150,877225087914,3379764,-1
625,1,STEP,877225164413,877228500678,3336265,-1
626,1,STEP,877228575977,877231475647,2899670,-1
627,1,STEP,877231548146,877234773612,3225466,-1
628,1,STEP,877234849211,877238060178,3210967,-1
629,1,STEP,877238132977,877241034846,2901869,-1
630,1,STEP,877241119445,877244641108,3521663,-1
631,1,STEP,877244710908,877247558978,2848070,-1
632,1,STEP,877247630477,877250619045,2988568,-1
633,1,STEP,877250690645,877253664113,2973468,-1
634,1,STEP,877253735112,877256687181,2952069,-1
635,1,STEP,877256758781,877259608351,2849570,-1
636,1,STEP,877259678750,877262136324,2457574,-1
637,1,STEP,877262207523,877265647787,3440264,-1
638,1,STEP,877265720586,877268931452,3210866,-1
639,1,STEP,877269006052,877271734223,2728171,-1
640,1,STEP,877271806622,877274732091,2925469,-1
641,1,STEP,877274805791,877278004957,3199166,-1
642,1,STEP,877278079756,877281521420,3441664,-1
643,1,STEP,877281657718,877285991873,4334155,-1
644,1,STEP,877286123671,877289516936,3393265,-1
645,1,STEP,877289592735,877292792901,3200166,-1
646,1,STEP,877292869300,877296057867,3188567,-1
647,1,STEP,877296134266,877299676829,3542563,-1
648,1,STEP,877299751928,877302907895,3155967,-1
649,1,STEP,877302983294,877306701755,3718461,-1
650,1,STEP,877306777754,877309823122,3045368,-1
651,1,STEP,877309918821,877312738791,2819970,-1
652,1,STEP,877312814790,877316128155,3313365,-1
653,1,STEP,877316204355,877318966726,2762371,-1
654,1,STEP,877319042325,877322194892,3152567,-1
655,1,STEP,877322268891,877325516257,3247366,-1
656,1,STEP,877325589056,877328684023,3094967,-1
657,1,STEP,877328756322,877331789291,3032969,-1
658,1,STEP,877331863790,877334532462,2668672,-1
659,1,STEP,877334606061,877337934026,3327965,-1
660,1,STEP,877338008125,877341360390,3352265,-1
661,1,STEP,877341433189,877344732954,3299765,-1
662,1,STEP,877344806853,877347850521,3043668,-1
663,1,STEP,877347922321,877351174886,3252565,-1
664,1,STEP,877351250186,877354296354,3046168,-1
665,1,STEP,877354371453,877357806417,3434964,-1
666,1,STEP,877357889416,877360890784,3001368,-1
667,1,STEP,877360964783,877363975652,3010869,-1
668,1,STEP,877364075151,877366966320,2891169,-1
669,1,STEP,877367041219,877369643892,2602673,-1
670,1,STEP,877369715691,877374476441,4760750,-1
671,1,STEP,877374613040,877379622987,5009947,-1
672,1,STEP,877379761485,877384211538,4450053,-1
673,1,STEP,877384291138,877387359605,3068467,-1
674,1,STEP,877387459504,877390917468,3457964,-1
675,1,STEP,877391003767,877394376431,3372664,-1
676,1,STEP,877394451131,877397716296,3265165,-1
677,1,STEP,877397819795,877401027661,3207866,-1
678,1,STEP,877401103961,877403903531,2799570,-1
679,1,STEP,877403980130,877407193896,3213766,-1
680,1,STEP,877407268896,877410777259,3508363,-1
681,1,STEP,877410853658,877414069924,3216266,-1
682,1,STEP,877414145523,877417574487,3428964,-1
683,1,STEP,877417673686,877420932952,3259266,-1
684,1,STEP,877421007751,877424017419,3009668,-1
685,1,STEP,877424090919,877427797480,3706561,-1
686,1,STEP,877427871879,877430856647,2984768,-1
687,1,STEP,877430942446,877435886694,4944248,-1
688,1,STEP,877436019793,877440524845,4505052,-1
689,1,STEP,877440675844,877445914389,5238545,-1
690,1,STEP,877446061787,877450788937,4727150,-1
691,1,STEP,877450923536,877455049693,4126157,-1
692,1,STEP,877455126592,877459245548,4118956,-1
693,1,STEP,877459324248,877462410515,3086267,-1
694,1,STEP,877462492314,877465662981,3170667,-1
695,1,STEP,877465740480,877468649849,2909369,-1
696,1,STEP,877468727649,877471459420,2731771,-1
697,1,STEP,877471558319,877474678986,3120667,-1
698,1,STEP,877474811384,877479035040,4223656,-1
699,1,STEP,877479161439,877482672102,3510663,-1
700,1,STEP,877482789100,877486033466,3244366,-1
701,1,STEP,877486148965,877489321932,3172967,-1
702,1,STEP,877489447330,877492891394,3444064,-1
703,1,STEP,877493007193,877495756664,2749471,-1
704,1,STEP,877495874763,877498984930,3110167,-1
705,1,STEP,877499100629,877501853300,2752671,-1
706,1,STEP,877501982998,877504557871,2574873,-1
707,1,STEP,877504672470,877507682238,3009768,-1
708,1,STEP,877507800637,877510907704,3107067,-1
709,1,STEP,877511025703,877514219769,3194066,-1
710,1,STEP,877514337268,877517599734,3262466,-1
711,1,STEP,877517717333,877520914599,3197266,-1
712,1,STEP,877521036298,877524370663,3334365,-1
713,1,STEP,877524489461,877529119113,4629652,-1
714,1,STEP,877529261711,877532637976,3376265,-1
715,1,STEP,877532714375,877536108039,3393664,-1
716,1,STEP,877536224638,877539451204,3226566,-1
717,1,STEP,877539561703,877542520371,2958668,-1
718,1,STEP,877542608371,877545290242,2681871,-1
719,1,STEP,877545372041,877548508308,3136267,-1
720,1,STEP,877548605607,877552822063,4216456,-1
721,1,STEP,877552945562,877557669512,4723950,-1
722,1,STEP,877557808710,877563335652,5526942,-1
723,1,STEP,877563423951,877566513519,3089568,-1
724,1,STEP,877566588118,877570572776,3984658,-1
725,1,STEP,877570650175,877573967040,3316865,-1
726,1,STEP,877574043039,877577071308,3028269,-1
727,1,STEP,877577144007,877580319873,3175866,-1
728,1,STEP,877580392873,877583405541,3012668,-1
729,1,STEP,877583478540,877586913404,3434864,-1
730,1,STEP,877586984503,877590653865,3669362,-1
731,1,STEP,877590727164,877593815831,3088667,-1
732,1,STEP,877593910430,877597128996,3218566,-1
733,1,STEP,877597213595,877600342963,3129368,-1
734,1,STEP,877600417262,877603440430,3023168,-1
735,1,STEP,877603527429,877606625996,3098567,-1
736,1,STEP,877606702796,877609732464,3029668,-1
737,1,STEP,877609805463,877612523334,2717871,-1
738,1,STEP,877612596534,877615463703,2867169,-1
739,1,STEP,877615537603,877618651170,3113567,-1
740,1,STEP,877618725169,877621478440,2753271,-1
741,1,STEP,877621550739,877624425209,2874470,-1
742,1,STEP,877624499508,877627651775,3152267,-1
743,1,STEP,877627725474,877631378636,3653162,-1
744,1,STEP,877631453835,877634481603,3027768,-1
745,1,STEP,877634557102,877637941567,3384465,-1
746,1,STEP,877638018866,877642341420,4322554,-1
747,1,STEP,877642484119,877646742174,4258055,-1
748,1,STEP,877646883572,877651152127,4268555,-1
749,1,STEP,877651229927,877653590102,2360175,-1
750,1,STEP,877653659401,877656783968,3124567,-1
751,1,STEP,877656856467,877660000134,3143667,-1
752,1,STEP,877660074834,877663000503,2925669,-1
753,1,STEP,877663072402,877665644375,2571973,-1
754,1,STEP,877665715074,877668952640,3237566,-1
755,1,STEP,877669025639,877671633412,2607773,-1
756,1,STEP,877671705211,877674675680,2970469,-1
757,1,STEP,877674746779,877677463250,2716471,-1
758,1,STEP,877677531650,877680861215,3329565,-1
759,1,STEP,877680934814,877684148880,3214066,-1
760,1,STEP,877684220479,877686825652,2605173,-1
761,1,STEP,877686897951,877690163017,3265066,-1
762,1,STEP,877690235916,877693149985,2914069,-1
763,1,STEP,877693221484,877696023355,2801871,-1
764,1,STEP,877696094654,877698809826,2715172,-1
765,1,STEP,877698881225,877701609096,2727871,-1
766,1,STEP,877701678895,877704725563,3046668,-1
767,1,STEP,877704793863,877708131527,3337664,-1
768,1,STEP,877708213827,877710987497,2773670,-1
769,1,STEP,877711056397,877713396772,2340375,-1
770,1,STEP,877713465571,877716845836,3380265,-1
771,1,STEP,877716920235,877720020902,3100667,-1
772,1,STEP,877720094002,877723069070,2975068,-1
773,1,STEP,877723143469,877726748931,3605462,-1
774,1,STEP,877726823631,877729754900,2931269,-1
775,1,STEP,877729828999,877732942566,3113567,-1
776,1,STEP,877733016865,877736415530,3398665,-1
777,1,STEP,877736490129,877740600886,4110757,-1
778,1,STEP,877740677985,877743800652,3122667,-1
779,1,STEP,877743875851,877747161216,3285365,-1
780,1,STEP,877747237716,877749937687,2699971,-1
781,1,STEP,877750013186,877752457961,2444775,-1
782,1,STEP,877752530660,877755709626,3178966,-1
783,1,STEP,877755785726,877758750394,2964668,-1
784,1,STEP,877758826494,877761615264,2788770,-1
785,1,STEP,877761689663,877764942929,3253266,-1
786,1,STEP,877765018728,877768151795,3133067,-1
787,1,STEP,877768225295,877770907466,2682171,-1
788,1,STEP,877770977666,877774316031,3338365,-1
789,1,STEP,877774391830,877777584496,3192666,-1
790,1,STEP,877777660595,877781214158,3553563,-1
791,1,STEP,877781290757,877784486023,3195266,-1
792,1,STEP,877784560923,877787865088,3304165,-1
793,1,STEP,877787940687,877791173453,3232766,-1
794,1,STEP,877791248952,877795472308,4223356,-1
795,1,STEP,877795598206,877799148669,3550463,-1
796,1,STEP,877799228268,877802671832,3443564,-1
797,1,STEP,877802749231,877805425903,2676672,-1
798,1,STEP,877805498502,877809528960,4030458,-1
799,1,STEP,877809633559,877812849825,3216266,-1
800,1,STEP,877812927224,877815874793,2947569,-1
801,1,STEP,877815962892,877819413756,3450864,-1
802,1,STEP,877819502955,877822094027,2591072,-1
803,1,STEP,877822185626,877825934787,3749161,-1
804,1,STEP,877826025486,877829627948,3602462,-1
805,1,STEP,877829721747,877832493518,2771771,-1
806,1,STEP,877832570817,877835844583,3273766,-1
807,1,STEP,877835937882,877839090848,3152966,-1
808,1,STEP,877839176348,877841976118,2799770,-1
809,1,STEP,877842063117,877845003386,2940269,-1
810,1,STEP,877845093885,877847746057,2652172,-1
811,1,STEP,877847834856,877850997123,3162267,-1
812,1,STEP,877851083822,877854432387,3348565,-1
813,1,STEP,877854544686,877857531554,2986868,-1
814,1,STEP,877857646453,877860594122,2947669,-1
815,1,STEP,877860710621,877864474281,3763660,-1
816,1,STEP,877864592480,877868370340,3777860,-1
817,1,STEP,877868488139,877871806504,3318365,-1
818,1,STEP,877871923903,877875079569,3155666,-1
819,1,STEP,877875197268,877878288436,3091168,-1
820,1,STEP,877878404334,877881196905,2792571,-1
821,1,STEP,877881314204,877884365672,3051468,-1
822,1,STEP,877884475570,877887304941,2829371,-1
823,1,STEP,877887422139,877890626706,3204567,-1
824,1,STEP,877890744804,877893258878,2514074,-1
825,1,STEP,877893373877,877896146948,2773071,-1
826,1,STEP,877896262246,877899553712,3291466,-1
827,1,STEP,877899670810,877902162684,2491874,-1
828,1,STEP,877902277683,877905100153,2822470,-1
829,1,STEP,877905215152,877908149321,2934169,-1
830,1,STEP,877908264520,877911008391,2743871,-1
831,1,STEP,877911124290,877913934360,2810070,-1
832,1,STEP,877914047959,877917146126,3098167,-1
833,1,STEP,877917260225,877919916697,2656472,-1
834,1,STEP,877920031096,877923121964,3090868,-1
835,1,STEP,877923236862,877926166331,2929469,-1
836,1,STEP,877926280630,877929795993,3515363,-1
837,1,STEP,877929923892,877932902561,2978669,-1
838,1,STEP,877933017459,877935847630,2830171,-1
839,1,STEP,877935964928,877938639300,2674372,-1
840,1,STEP,877938752899,877941690868,2937969,-1
841,1,STEP,877941805267,877944757736,2952469,-1
842,1,STEP,877944873634,877947723104,2849470,-1
843,1,STEP,877947837603,877951256267,3418664,-1
844,1,STEP,877951376666,877954654831,3278165,-1
845,1,STEP,877954771230,877958035696,3264466,-1
846,1,STEP,877958152195,877961580259,3428064,-1
847,1,STEP,877961697257,877965130721,3433464,-1
848,1,STEP,877965247320,877968660984,3413664,-1
849,1,STEP,877968777483,877972414144,3636661,-1
850,1,STEP,877972531943,877975446613,2914670,-1
851,1,STEP,877975564011,877978932076,3368065,-1
852,1,STEP,877979051475,877982817035,3765560,-1
853,1,STEP,877982935534,877986271099,3335565,-1
854,1,STEP,877986397197,877989302167,2904970,-1
855,1,STEP,877989418465,877992410634,2992169,-1
856,1,STEP,877992530233,877995514901,2984668,-1
857,1,STEP,877995632200,877998827766,3195566,-1
858,1,STEP,877998946265,878002541627,3595362,-1
859,1,STEP,878002660126,878006075690,3415564,-1
860,1,STEP,878006193989,878009557753,3363764,-1
861,1,STEP,878009675152,878012950118,3274966,-1
862,1,STEP,878013068516,878016629379,3560863,-1
863,1,STEP,878016749078,878020260441,3511363,-1
864,1,STEP,878020378739,878023754304,3375565,-1
865,1,STEP,878023871603,878027153068,3281465,-1
866,1,STEP,878027278167,878030244435,2966268,-1
867,1,STEP,878030362734,878033538001,3175267,-1
868,1,STEP,878033654500,878036868766,3214266,-1
869,1,STEP,878036985864,878040560627,3574763,-1
870,1,STEP,878040680226,878044901881,4221655,-1
871,1,STEP,878045057080,878048031548,2974468,-1
872,1,STEP,878048107647,878051379813,3272166,-1
873,1,STEP,878051458012,878054574879,3116867,-1
874,1,STEP,878054651678,878057522648,2870970,-1
875,1,STEP,878057596347,878060755714,3159367,-1
876,1,STEP,878060831513,878063884381,3052868,-1
877,1,STEP,878063960080,878066919249,2959169,-1
878,1,STEP,878066993848,878070586511,3592663,-1
879,1,STEP,878070665610,878073692778,3027168,-1
880,1,STEP,878073767577,878077317040,3549463,-1
881,1,STEP,878077394339,878080953501,3559162,-1
882,1,STEP,878081062700,878083747272,2684572,-1
883,1,STEP,878083817071,878086593442,2776371,-1
884,1,STEP,878086664641,878089245614,2580973,-1
885,1,STEP,878089314913,878092630379,3315466,-1
886,1,STEP,878092701978,878095560948,2858970,-1
887,1,STEP,878095631847,878098654315,3022468,-1
888,1,STEP,878098725614,878101360887,2635273,-1
889,1,STEP,878101429386,878104690352,3260966,-1
890,1,STEP,878104762451,878107715320,2952869,-1
891,1,STEP,878107785419,878111097484,3312065,-1
892,1,STEP,878111169983,878114118552,2948569,-1
893,1,STEP,878114189552,878116496127,2306575,-1
894,1,STEP,878116561827,878119456196,2894369,-1
895,1,STEP,878119526295,878122198967,2672672,-1
896,1,STEP,878122269666,878125376034,3106368,-1
897,1,STEP,878125446933,878128567700,3120767,-1
898,1,STEP,878128638899,878131274672,2635773,-1
899,1,STEP,878131345671,878134809034,3463363,-1
900,1,STEP,878134882334,878137428107,2545773,-1
901,1,STEP,878137495506,878140556574,3061068,-1
902,1,STEP,878140628673,878143452643,2823970,-1
903,1,STEP,878143523343,878146570611,3047268,-1
904,1,STEP,878146643110,878149791677,3148567,-1
905,1,STEP,878149861576,878152598347,2736771,-1
906,1,STEP,878152666646,878155544416,2877770,-1
907,1,STEP,878155615915,878158798782,3182867,-1
908,1,STEP,878158871781,878161586452,2714671,-1
909,1,STEP,878161656652,878164253824,2597172,-1
910,1,STEP,878164321224,878166970896,2649672,-1
911,1,STEP,878167040495,878170429359,3388864,-1
912,1,STEP,878170501059,878172890433,2389374,-1
913,1,STEP,878172961333,878175984501,3023168,-1
914,1,STEP,878176055900,878179102868,3046968,-1
915,1,STEP,878179174767,878182220535,3045768,-1
916,1,STEP,878182292334,878184805808,2513474,-1
917,1,STEP,878184873507,878187289682,2416175,-1
918,1,STEP,878187357581,878190251551,2893970,-1
919,1,STEP,878190321950,878193526116,3204166,-1
920,1,STEP,878193599915,878196865581,3265666,-1
921,1,STEP,878196939280,878200312245,3372965,-1
922,1,STEP,878200386944,878203085215,2698271,-1
923,1,STEP,878203158815,878206444980,3286165,-1
924,1,STEP,878206520579,878209082952,2562373,-1
925,1,STEP,878209155451,878212439317,3283866,-1
926,1,STEP,878212510416,878215576884,3066468,-1
927,1,STEP,878215650683,878218215356,2564673,-1
928,1,STEP,878218289755,878220933027,2643272,-1
929,1,STEP,878221004727,878224100694,3095967,-1
930,1,STEP,878224175193,878227000464,2825271,-1
931,1,STEP,878227074563,878229729035,2654472,-1
932,1,STEP,878229801734,878233264798,3463064,-1
933,1,STEP,878233339697,878236509963,3170266,-1
934,1,STEP,878236584763,878239823329,3238566,-1
935,1,STEP,878239898928,878244020784,4121856,-1
936,1,STEP,878244160983,878249500227,5339244,-1
937,1,STEP,878249619025,878253058689,3439664,-1
938,1,STEP,878253178388,878257202146,4023758,-1
939,1,STEP,878257344544,878261518500,4173956,-1
940,1,STEP,878261651799,878266525347,4873548,-1
941,1,STEP,878266658546,878271243898,4585352,-1
942,1,STEP,878271378196,878275482853,4104657,-1
943,1,STEP,878275613652,878279764108,4150456,-1
944,1,STEP,878279893007,878284372659,4479652,-1
945,1,STEP,878284504258,878288462916,3958658,-1
946,1,STEP,878288539116,878292003579,3464463,-1
947,1,STEP,878292077978,878295100046,3022068,-1
948,1,STEP,878295175946,878297452722,2276776,-1
949,1,STEP,878297515421,878302220971,4705550,-1
950,1,STEP,878302302371,878305807134,3504763,-1
951,1,STEP,878305901733,878309003500,3101767,-1
952,1,STEP,878309084399,878312591762,3507363,-1
953,1,STEP,878312678661,878315179935,2501274,-1
954,1,STEP,878315253634,878318615399,3361765,-1
955,1,STEP,878318707198,878321631767,2924569,-1
956,1,STEP,878321717566,878325436727,3719161,-1
957,1,STEP,878325519726,878328738892,3219166,-1
958,1,STEP,878328813391,878332198256,3384865,-1
959,1,STEP,878332275155,878335538321,3263166,-1
960,1,STEP,878335612620,878338799186,3186566,-1
961,1,STEP,878338875185,878342394748,3519563,-1
962,1,STEP,878342472148,878345777913,3305765,-1
963,1,STEP,878345853012,878348755881,2902869,-1
964,1,STEP,878348829481,878351935148,3105667,-1
965,1,STEP,878352009547,878355508410,3498863,-1
966,1,STEP,878355584110,878358651677,3067567,-1
967,1,STEP,878358727576,878361554247,2826671,-1
968,1,STEP,878361626946,878364687914,3060968,-1
969,1,STEP,878364761813,878367324286,2562473,-1
970,1,STEP,878367398285,878370098057,2699772,-1
971,1,STEP,878370173356,878373099925,2926569,-1
972,1,STEP,878373173324,878376234292,3060968,-1
973,1,STEP,878376307091,878379193861,2886770,-1
974,1,STEP,878379266860,878382264429,2997569,-1
975,1,STEP,878382338428,878385391196,3052768,-1
976,1,STEP,878385465395,878388621762,3156367,-1
977,1,STEP,878388694361,878391380233,2685872,-1
978,1,STEP,878391453532,878394597499,3143967,-1
979,1,STEP,878394672098,878397803165,3131067,-1
980,1,STEP,878397886764,878400997431,3110667,-1
981,1,STEP,878401071231,878403842901,2771670,-1
982,1,STEP,878403917301,878406959369,3042068,-1
983,1,STEP,878407035168,878410181235,3146067,-1
984,1,STEP,878410256834,878413025905,2769071,-1
985,1,STEP,878413099804,878415947674,2847870,-1
986,1,STEP,878416021473,878418650745,2629272,-1
987,1,STEP,878418723545,878421963711,3240166,-1
988,1,STEP,878422037810,878425084478,3046668,-1
989,1,STEP,878425157177,878428089046,2931869,-1
990,1,STEP,878428164045,878430671119,2507074,-1
991,1,STEP,878430744418,878433704187,2959769,-1
992,1,STEP,878433777286,878436679256,2901970,-1
993,1,STEP,878436753455,878439675324,2921869,-1
994,1,STEP,878439747223,878442458295,2711072,-1
995,1,STEP,878442532494,878446040057,3507563,-1
996,1,STEP,878446115256,878448999726,2884470,-1
997,1,STEP,878449073925,878452159893,3085968,-1
998,1,STEP,878452233792,878455267260,3033468,-1
999,1,STEP,878455340059,878458401527,3061468,-1
