Gen,Resource,Stamp,TimeStamp_Start,TimeStamp_End,Duration,Indiv_id
0,1,FirstEvaluation,989897009040,990769942920,872933880,-1
0,1,STEP,990770134018,990775958371,5824353,-1
1,1,STEP,990776036170,990780538433,4502263,-1
2,1,STEP,990780607833,990785415994,4808161,-1
3,1,STEP,990785487193,990789642959,4155766,-1
4,1,STEP,990789711459,990793128431,3416972,-1
5,1,STEP,990793197130,990797751193,4554063,-1
6,1,STEP,990797821092,990802169657,4348565,-1
7,1,STEP,990802238456,990806416522,4178066,-1
8,1,STEP,990806486022,990809989893,3503871,-1
9,1,STEP,990810057393,990814914453,4857060,-1
10,1,STEP,990814985652,990818534423,3548771,-1
11,1,STEP,990818601623,990823362384,4760761,-1
12,1,STEP,990823430784,990828348343,4917559,-1
13,1,STEP,990828417143,990832575309,4158166,-1
14,1,STEP,990832643908,990836787775,4143867,-1
15,1,STEP,990836856174,990840098048,3241874,-1
16,1,STEP,990840165447,990844323513,4158066,-1
17,1,STEP,990844391313,990848534679,4143366,-1
18,1,STEP,990848603678,990852182849,3579171,-1
19,1,STEP,990852251148,990855383023,3131875,-1
20,1,STEP,990855457222,990859698788,4241566,-1
21,1,STEP,990859768887,990863359158,3590271,-1
22,1,STEP,990863434057,990866505932,3071875,-1
23,1,STEP,990866574832,990870530299,3955467,-1
24,1,STEP,990870604799,990875136562,4531763,-1
25,1,STEP,990875207361,990879082230,3874869,-1
26,1,STEP,990879152029,990883280895,4128866,-1
27,1,STEP,990883349495,990887401962,4052467,-1
28,1,STEP,990887470061,990890974833,3504772,-1
29,1,STEP,990891038432,990896159090,5120658,-1
30,1,STEP,990896228790,990899892460,3663670,-1
31,1,STEP,990899962359,990904025326,4062967,-1
32,1,STEP,990904106226,990908357091,4250865,-1
33,1,STEP,990908443890,990911776363,3332473,-1
34,1,STEP,990911846862,990915355534,3508672,-1
35,1,STEP,990915426533,990918642007,3215474,-1
36,1,STEP,990918712906,990922189578,3476672,-1
37,1,STEP,990922260377,990925314253,3053876,-1
38,1,STEP,990925382652,990928204029,2821377,-1
39,1,STEP,990928273528,990931336203,3062675,-1
40,1,STEP,990931404703,990934746676,3341973,-1
41,1,STEP,990934816275,990938149148,3332873,-1
42,1,STEP,990938233447,990942067416,3833969,-1
43,1,STEP,990942138415,990945215190,3076775,-1
44,1,STEP,990945283390,990948424164,3140774,-1
45,1,STEP,990948494064,990951970135,3476071,-1
46,1,STEP,990952040435,990955085010,3044575,-1
47,1,STEP,990955155509,990957994686,2839177,-1
48,1,STEP,990958063685,990961062961,2999276,-1
49,1,STEP,990961131660,990963987837,2856177,-1
50,1,STEP,990964057637,990967396509,3338872,-1
51,1,STEP,990967466509,990970839981,3373472,-1
52,1,STEP,990970909681,990974511151,3601470,-1
53,1,STEP,990974586051,990977503427,2917376,-1
54,1,STEP,990977573126,990980881899,3308773,-1
55,1,STEP,990980953699,990984423270,3469571,-1
56,1,STEP,990984496170,990987817843,3321673,-1
57,1,STEP,990987889142,990990656220,2767078,-1
58,1,STEP,990990726319,990993254698,2528379,-1
59,1,STEP,990993323498,990995881477,2557979,-1
60,1,STEP,990995951876,990998693454,2741578,-1
61,1,STEP,990998763353,991001992927,3229574,-1
62,1,STEP,991002064627,991004915303,2850676,-1
63,1,STEP,991004984003,991008131277,3147274,-1
64,1,STEP,991008202377,991011821047,3618670,-1
65,1,STEP,991011892346,991015510917,3618571,-1
66,1,STEP,991015582116,991018009697,2427581,-1
67,1,STEP,991018081096,991021111671,3030575,-1
68,1,STEP,991021182271,991024091347,2909076,-1
69,1,STEP,991024163046,991026898724,2735678,-1
70,1,STEP,991026969123,991029515603,2546480,-1
71,1,STEP,991029586302,991032573378,2987076,-1
72,1,STEP,991032645277,991035836251,3190974,-1
73,1,STEP,991035907051,991039308423,3401372,-1
74,1,STEP,991039380522,991042521197,3140675,-1
75,1,STEP,991042592296,991045665371,3073075,-1
76,1,STEP,991045736170,991048450648,2714478,-1
77,1,STEP,991048522148,991051420124,2897976,-1
78,1,STEP,991051489623,991054373600,2883977,-1
79,1,STEP,991054445599,991057168577,2722978,-1
80,1,STEP,991057238077,991060243552,3005475,-1
81,1,STEP,991060314951,991062982630,2667679,-1
82,1,STEP,991063054329,991066030105,2975776,-1
83,1,STEP,991066102604,991068921181,2818577,-1
84,1,STEP,991068992381,991072052156,3059775,-1
85,1,STEP,991072135855,991074983732,2847877,-1
86,1,STEP,991075055631,991078088707,3033076,-1
87,1,STEP,991078161506,991081140182,2978676,-1
88,1,STEP,991081213081,991084119057,2905976,-1
89,1,STEP,991084193157,991086956234,2763077,-1
90,1,STEP,991087025134,991090231107,3205973,-1
91,1,STEP,991090305507,991093752379,3446872,-1
92,1,STEP,991093827078,991097178951,3351873,-1
93,1,STEP,991097252350,991099937428,2685078,-1
94,1,STEP,991100017028,991102912804,2895776,-1
95,1,STEP,991102986503,991106198477,3211974,-1
96,1,STEP,991106270577,991109116853,2846276,-1
97,1,STEP,991109188953,991111990130,2801177,-1
98,1,STEP,991112061429,991114876406,2814977,-1
99,1,STEP,991114947606,991118024481,3076875,-1
100,1,STEP,991118096580,991120691859,2595279,-1
101,1,STEP,991120762258,991123627735,2865477,-1
102,1,STEP,991123700634,991126675410,2974776,-1
103,1,STEP,991126749210,991129446588,2697378,-1
104,1,STEP,991129517987,991132216865,2698878,-1
105,1,STEP,991132288864,991135566238,3277374,-1
106,1,STEP,991135640137,991138696712,3056575,-1
107,1,STEP,991138768012,991141641188,2873176,-1
108,1,STEP,991141712488,991145035960,3323472,-1
109,1,STEP,991145110160,991148104235,2994075,-1
110,1,STEP,991148177835,991151235010,3057175,-1
111,1,STEP,991151307109,991154347585,3040476,-1
112,1,STEP,991154419684,991157232561,2812877,-1
113,1,STEP,991157304260,991159988939,2684679,-1
114,1,STEP,991160061538,991163134013,3072475,-1
115,1,STEP,991163206812,991165946790,2739978,-1
116,1,STEP,991166020389,991169198963,3178574,-1
117,1,STEP,991169270663,991172470337,3199674,-1
118,1,STEP,991172542736,991175939708,3396972,-1
119,1,STEP,991176012908,991179374380,3361472,-1
120,1,STEP,991179446780,991182839252,3392472,-1
121,1,STEP,991182913052,991186220725,3307673,-1
122,1,STEP,991186294624,991189303899,3009275,-1
123,1,STEP,991189374599,991192341675,2967076,-1
124,1,STEP,991192413574,991195571448,3157874,-1
125,1,STEP,991195643148,991198423425,2780277,-1
126,1,STEP,991198495024,991201413501,2918477,-1
127,1,STEP,991201485000,991204872572,3387572,-1
128,1,STEP,991204975172,991208279245,3304073,-1
129,1,STEP,991208367244,991211693017,3325773,-1
130,1,STEP,991211772916,991214635193,2862277,-1
131,1,STEP,991214706592,991217584569,2877977,-1
132,1,STEP,991217654668,991220391646,2736978,-1
133,1,STEP,991220462445,991223343222,2880777,-1
134,1,STEP,991223416121,991226657295,3241174,-1
135,1,STEP,991226728094,991229727770,2999676,-1
136,1,STEP,991229797369,991232518547,2721178,-1
137,1,STEP,991232588546,991236105118,3516572,-1
138,1,STEP,991236176117,991239153393,2977276,-1
139,1,STEP,991239222492,991242129769,2907277,-1
140,1,STEP,991242199568,991245353642,3154074,-1
141,1,STEP,991245425142,991248600416,3175274,-1
142,1,STEP,991248671115,991252365285,3694170,-1
143,1,STEP,991252436684,991255485360,3048676,-1
144,1,STEP,991255556659,991257948440,2391781,-1
145,1,STEP,991258018939,991261702309,3683370,-1
146,1,STEP,991261775408,991264555886,2780478,-1
147,1,STEP,991264627785,991267407562,2779777,-1
148,1,STEP,991267480062,991270348738,2868676,-1
149,1,STEP,991270420738,991273763611,3342873,-1
150,1,STEP,991273835310,991276878285,3042975,-1
151,1,STEP,991276947885,991280292357,3344472,-1
152,1,STEP,991280363357,991283499031,3135674,-1
153,1,STEP,991283569531,991286235809,2666278,-1
154,1,STEP,991286306108,991289241484,2935376,-1
155,1,STEP,991289311584,991292476358,3164774,-1
156,1,STEP,991292546357,991295140136,2593779,-1
157,1,STEP,991295208836,991298252111,3043275,-1
158,1,STEP,991298321510,991301817382,3495872,-1
159,1,STEP,991301896481,991304978756,3082275,-1
160,1,STEP,991305049155,991308464128,3414973,-1
161,1,STEP,991308564727,991311996899,3432172,-1
162,1,STEP,991312113098,991315399871,3286773,-1
163,1,STEP,991315522670,991318473146,2950476,-1
164,1,STEP,991318581745,991321834118,3252373,-1
165,1,STEP,991321955517,991324958693,3003176,-1
166,1,STEP,991325067492,991328086367,3018875,-1
167,1,STEP,991328189567,991331206242,3016675,-1
168,1,STEP,991331308341,991334567015,3258674,-1
169,1,STEP,991334675314,991337512191,2836877,-1
170,1,STEP,991337619190,991340545566,2926376,-1
171,1,STEP,991340668965,991343678140,3009175,-1
172,1,STEP,991343789039,991346499817,2710778,-1
173,1,STEP,991346612116,991349741991,3129875,-1
174,1,STEP,991349853490,991353087664,3234174,-1
175,1,STEP,991353201063,991355989040,2787977,-1
176,1,STEP,991356100539,991359428312,3327773,-1
177,1,STEP,991359536411,991362669985,3133574,-1
178,1,STEP,991362781084,991365421263,2640179,-1
179,1,STEP,991365533062,991368984434,3451372,-1
180,1,STEP,991369095133,991371867210,2772077,-1
181,1,STEP,991371982109,991374706887,2724778,-1
182,1,STEP,991374817986,991377631063,2813077,-1
183,1,STEP,991377742562,991380665839,2923277,-1
184,1,STEP,991380778138,991384207410,3429272,-1
185,1,STEP,991384318809,991387574782,3255973,-1
186,1,STEP,991387688481,991390248560,2560079,-1
187,1,STEP,991390359360,991393317935,2958575,-1
188,1,STEP,991393429135,991396422110,2992975,-1
189,1,STEP,991396533609,991399110488,2576879,-1
190,1,STEP,991399220087,991401983665,2763578,-1
191,1,STEP,991402093764,991405090539,2996775,-1
192,1,STEP,991405200339,991407800217,2599878,-1
193,1,STEP,991407910416,991410799393,2888977,-1
194,1,STEP,991410911292,991413725769,2814477,-1
195,1,STEP,991413837568,991416735744,2898176,-1
196,1,STEP,991416846144,991420455914,3609770,-1
197,1,STEP,991420567713,991423325291,2757578,-1
198,1,STEP,991423436790,991426546764,3109974,-1
199,1,STEP,991426657663,991429815638,3157975,-1
200,1,STEP,991429935337,991432842313,2906976,-1
201,1,STEP,991432953212,991435935988,2982776,-1
202,1,STEP,991436047487,991439278061,3230574,-1
203,1,STEP,991439390160,991442216337,2826177,-1
204,1,STEP,991442329436,991445627909,3298473,-1
205,1,STEP,991445741308,991448762383,3021075,-1
206,1,STEP,991448872882,991452636052,3763170,-1
207,1,STEP,991452747751,991455748326,3000575,-1
208,1,STEP,991455858525,991458747502,2888977,-1
209,1,STEP,991458857501,991461954076,3096575,-1
210,1,STEP,991462065875,991464630654,2564779,-1
211,1,STEP,991464741553,991467918827,3177274,-1
212,1,STEP,991468031326,991471263800,3232474,-1
213,1,STEP,991471375799,991474890370,3514571,-1
214,1,STEP,991475001269,991478356742,3355473,-1
215,1,STEP,991478465041,991481222518,2757477,-1
216,1,STEP,991481330018,991484808689,3478671,-1
217,1,STEP,991484917188,991487952964,3035776,-1
218,1,STEP,991488063563,991491356536,3292973,-1
219,1,STEP,991491468235,991494307712,2839477,-1
220,1,STEP,991494417411,991497815483,3398072,-1
221,1,STEP,991497943482,991500872358,2928876,-1
222,1,STEP,991500982557,991504657627,3675070,-1
223,1,STEP,991504769826,991508194598,3424772,-1
224,1,STEP,991508306998,991511518071,3211073,-1
225,1,STEP,991511628370,991514853844,3225474,-1
226,1,STEP,991514965443,991517956219,2990776,-1
227,1,STEP,991518068218,991521101093,3032875,-1
228,1,STEP,991521212492,991524003970,2791478,-1
229,1,STEP,991524116469,991527113644,2997175,-1
230,1,STEP,991527226443,991530602416,3375973,-1
231,1,STEP,991530713815,991533757990,3044175,-1
232,1,STEP,991533876989,991536420368,2543379,-1
233,1,STEP,991536530567,991539785641,3255074,-1
234,1,STEP,991539898140,991542676517,2778377,-1
235,1,STEP,991542790016,991546638185,3848169,-1
236,1,STEP,991546751484,991549696660,2945176,-1
237,1,STEP,991549805559,991553348330,3542771,-1
238,1,STEP,991553459529,991556203307,2743778,-1
239,1,STEP,991556310806,991559461380,3150574,-1
240,1,STEP,991559577979,991563102551,3524572,-1
241,1,STEP,991563221550,991566464023,3242473,-1
242,1,STEP,991566582422,991569575898,2993476,-1
243,1,STEP,991569688897,991572860571,3171674,-1
244,1,STEP,991572971670,991576339143,3367473,-1
245,1,STEP,991576453242,991580295810,3842568,-1
246,1,STEP,991580415009,991582889289,2474280,-1
247,1,STEP,991583001388,991585677766,2676378,-1
248,1,STEP,991585787566,991588763541,2975975,-1
249,1,STEP,991588876540,991591953215,3076675,-1
250,1,STEP,991592066414,991595908083,3841669,-1
251,1,STEP,991596026182,991599155657,3129475,-1
252,1,STEP,991599271256,991602561229,3289973,-1
253,1,STEP,991602674528,991605339806,2665278,-1
254,1,STEP,991605451305,991608664779,3213474,-1
255,1,STEP,991608773478,991612110751,3337273,-1
256,1,STEP,991612274150,991615401624,3127474,-1
257,1,STEP,991615521623,991618823296,3301673,-1
258,1,STEP,991618938095,991621605973,2667878,-1
259,1,STEP,991621717173,991624941246,3224073,-1
260,1,STEP,991625054845,991628702416,3647571,-1
261,1,STEP,991628817515,991631744591,2927076,-1
262,1,STEP,991631857090,991634809966,2952876,-1
263,1,STEP,991634925265,991638775233,3849968,-1
264,1,STEP,991638890332,991641997207,3106875,-1
265,1,STEP,991642110106,991644589586,2479480,-1
266,1,STEP,991644700185,991647894559,3194374,-1
267,1,STEP,991648005558,991651429530,3423972,-1
268,1,STEP,991651545329,991654077509,2532180,-1
269,1,STEP,991654192408,991657268783,3076375,-1
270,1,STEP,991657382882,991660799954,3417072,-1
271,1,STEP,991660913453,991664240726,3327273,-1
272,1,STEP,991664355725,991667588198,3232473,-1
273,1,STEP,991667702797,991670145978,2443181,-1
274,1,STEP,991670258677,991672921955,2663278,-1
275,1,STEP,991673035054,991676327227,3292173,-1
276,1,STEP,991676442026,991679726299,3284273,-1
277,1,STEP,991679840998,991682752275,2911277,-1
278,1,STEP,991682865674,991685934149,3068475,-1
279,1,STEP,991686048648,991689118123,3069475,-1
280,1,STEP,991689229322,991692645694,3416372,-1
281,1,STEP,991692761593,991695378472,2616879,-1
282,1,STEP,991695496771,991698410847,2914076,-1
283,1,STEP,991698528346,991701435122,2906776,-1
284,1,STEP,991701551921,991704757495,3205574,-1
285,1,STEP,991704877794,991708056068,3178274,-1
286,1,STEP,991708169967,991711448141,3278174,-1
287,1,STEP,991711566740,991714521216,2954476,-1
288,1,STEP,991714633915,991717710890,3076975,-1
289,1,STEP,991717825889,991720297469,2471580,-1
290,1,STEP,991720411368,991723274844,2863476,-1
291,1,STEP,991723391743,991726159821,2768078,-1
292,1,STEP,991726272220,991729567193,3294973,-1
293,1,STEP,991729679692,991732719167,3039475,-1
294,1,STEP,991732836166,991736025740,3189574,-1
295,1,STEP,991736138439,991739564611,3426172,-1
296,1,STEP,991739679910,991742453588,2773678,-1
297,1,STEP,991742569487,991745556962,2987475,-1
298,1,STEP,991745664362,991748857736,3193374,-1
299,1,STEP,991748970535,991751821511,2850976,-1
300,1,STEP,991751930910,991755002285,3071375,-1
301,1,STEP,991755119184,991757593864,2474680,-1
302,1,STEP,991757706863,991760619940,2913077,-1
303,1,STEP,991760734639,991763722114,2987475,-1
304,1,STEP,991763835313,991766920788,3085475,-1
305,1,STEP,991767040487,991770154162,3113675,-1
306,1,STEP,991770268361,991773580434,3312073,-1
307,1,STEP,991773690933,991776459710,2768777,-1
308,1,STEP,991776576009,991779565785,2989776,-1
309,1,STEP,991779679184,991782195564,2516380,-1
310,1,STEP,991782309763,991785729335,3419572,-1
311,1,STEP,991785841334,991789069208,3227874,-1
312,1,STEP,991789179507,991792317081,3137574,-1
313,1,STEP,991792436280,991795508355,3072075,-1
314,1,STEP,991795626354,991798496331,2869977,-1
315,1,STEP,991798609030,991801628305,3019275,-1
316,1,STEP,991801741604,991804596681,2855077,-1
317,1,STEP,991804710080,991807519957,2809877,-1
318,1,STEP,991807636056,991810778031,3141975,-1
319,1,STEP,991810892330,991814195303,3302973,-1
320,1,STEP,991814307602,991817350077,3042475,-1
321,1,STEP,991817462376,991820844548,3382172,-1
322,1,STEP,991820962047,991824022122,3060075,-1
323,1,STEP,991824136822,991827547594,3410772,-1
324,1,STEP,991827662893,991830410570,2747677,-1
325,1,STEP,991830519670,991833774543,3254873,-1
326,1,STEP,991833894342,991837310014,3415672,-1
327,1,STEP,991837426013,991840409189,2983176,-1
328,1,STEP,991840519688,991843154566,2634878,-1
329,1,STEP,991843270566,991846294841,3024275,-1
330,1,STEP,991846403940,991849509715,3105775,-1
331,1,STEP,991849619414,991852722088,3102674,-1
332,1,STEP,991852832588,991855327867,2495279,-1
333,1,STEP,991855437866,991858672340,3234474,-1
334,1,STEP,991858780939,991861788114,3007175,-1
335,1,STEP,991861910413,991864653791,2743378,-1
336,1,STEP,991864770290,991867846865,3076575,-1
337,1,STEP,991867955864,991870924140,2968276,-1
338,1,STEP,991871026439,991874181813,3155374,-1
339,1,STEP,991874291112,991877182189,2891077,-1
340,1,STEP,991877296488,991880612461,3315973,-1
341,1,STEP,991880726960,991884035533,3308573,-1
342,1,STEP,991884163232,991887449605,3286373,-1
343,1,STEP,991887562904,991890906077,3343173,-1
344,1,STEP,991891020376,991894243750,3223374,-1
345,1,STEP,991894356249,991897273625,2917376,-1
346,1,STEP,991897378524,991900387100,3008576,-1
347,1,STEP,991900496899,991903619173,3122274,-1
348,1,STEP,991903737272,991907186944,3449672,-1
349,1,STEP,991907298843,991910761815,3462972,-1
350,1,STEP,991910874814,991914148787,3273973,-1
351,1,STEP,991914272786,991917522660,3249874,-1
352,1,STEP,991917639359,991920951732,3312373,-1
353,1,STEP,991921072331,991924089306,3016975,-1
354,1,STEP,991924207805,991927224181,3016376,-1
355,1,STEP,991927345980,991931030950,3684970,-1
356,1,STEP,991931146149,991934252023,3105874,-1
357,1,STEP,991934369122,991937460297,3091175,-1
358,1,STEP,991937577496,991940470373,2892877,-1
359,1,STEP,991940594972,991943711946,3116974,-1
360,1,STEP,991943839445,991947335917,3496472,-1
361,1,STEP,991947456716,991950496291,3039575,-1
362,1,STEP,991950611090,991953277868,2666778,-1
363,1,STEP,991953386567,991955944547,2557980,-1
364,1,STEP,991956059046,991959016621,2957575,-1
365,1,STEP,991959129821,991962335294,3205473,-1
366,1,STEP,991962445293,991965740567,3295274,-1
367,1,STEP,991965848366,991968825241,2976875,-1
368,1,STEP,991968937141,991971742618,2805477,-1
369,1,STEP,991971850917,991974821293,2970376,-1
370,1,STEP,991974929892,991977350972,2421080,-1
371,1,STEP,991977458771,991980652145,3193374,-1
372,1,STEP,991980787044,991984147516,3360472,-1
373,1,STEP,991984258316,991987156992,2898676,-1
374,1,STEP,991987269691,991990458365,3188674,-1
375,1,STEP,991990571864,991993432741,2860877,-1
376,1,STEP,991993545740,991996257018,2711278,-1
377,1,STEP,991996365317,991999623690,3258373,-1
378,1,STEP,991999732089,992002570866,2838777,-1
379,1,STEP,992002685265,992005672741,2987476,-1
380,1,STEP,992005786240,992008924614,3138374,-1
381,1,STEP,992009036813,992011693092,2656279,-1
382,1,STEP,992011805191,992015102664,3297473,-1
383,1,STEP,992015212863,992018184739,2971876,-1
384,1,STEP,992018300138,992021456112,3155974,-1
385,1,STEP,992021569811,992024573687,3003876,-1
386,1,STEP,992024686686,992027935559,3248873,-1
387,1,STEP,992028051258,992031151833,3100575,-1
388,1,STEP,992031265632,992034429806,3164174,-1
389,1,STEP,992034548505,992037284083,2735578,-1
390,1,STEP,992037400182,992040502457,3102275,-1
391,1,STEP,992040616656,992043679831,3063175,-1
392,1,STEP,992043796830,992047018304,3221474,-1
393,1,STEP,992047134203,992050295277,3161074,-1
394,1,STEP,992050408676,992053491151,3082475,-1
395,1,STEP,992053604150,992057057622,3453472,-1
396,1,STEP,992057172021,992060252896,3080875,-1
397,1,STEP,992060366695,992063164172,2797477,-1
398,1,STEP,992063279771,992066356246,3076475,-1
399,1,STEP,992066469845,992070104315,3634470,-1
400,1,STEP,992070221314,992073250590,3029276,-1
401,1,STEP,992073364889,992076336865,2971976,-1
402,1,STEP,992076450664,992078863144,2412480,-1
403,1,STEP,992078969243,992082331716,3362473,-1
404,1,STEP,992082450615,992085027194,2576579,-1
405,1,STEP,992085141893,992088116668,2974775,-1
406,1,STEP,992088229768,992091021945,2792177,-1
407,1,STEP,992091131044,992094565216,3434172,-1
408,1,STEP,992094682715,992098515484,3832769,-1
409,1,STEP,992098625383,992102751849,4126466,-1
410,1,STEP,992102840248,992106109222,3268974,-1
411,1,STEP,992106192321,992109560094,3367773,-1
412,1,STEP,992109645693,992112577169,2931476,-1
413,1,STEP,992112715268,992118353222,5637954,-1
414,1,STEP,992118489421,992121533096,3043675,-1
415,1,STEP,992121607495,992124073975,2466480,-1
416,1,STEP,992124196274,992127678546,3482272,-1
417,1,STEP,992127811345,992130535523,2724178,-1
418,1,STEP,992130659521,992133709897,3050376,-1
419,1,STEP,992133823496,992136895171,3071675,-1
420,1,STEP,992137010670,992139811447,2800777,-1
421,1,STEP,992139923246,992142863622,2940376,-1
422,1,STEP,992142973321,992146994788,4021467,-1
423,1,STEP,992147151387,992151615351,4463964,-1
424,1,STEP,992151709850,992154477627,2767777,-1
425,1,STEP,992154564227,992157848600,3284373,-1
426,1,STEP,992157953299,992161477470,3524171,-1
427,1,STEP,992161562769,992164133848,2571079,-1
428,1,STEP,992164204948,992167755519,3550571,-1
429,1,STEP,992167829118,992170937693,3108575,-1
430,1,STEP,992171011592,992173954668,2943076,-1
431,1,STEP,992174027968,992177091543,3063575,-1
432,1,STEP,992177162942,992179904020,2741078,-1
433,1,STEP,992179975219,992183454491,3479272,-1
434,1,STEP,992183527290,992186211668,2684378,-1
435,1,STEP,992186283068,992189558441,3275373,-1
436,1,STEP,992189630541,992192561317,2930776,-1
437,1,STEP,992192634016,992195797690,3163674,-1
438,1,STEP,992195870290,992199328661,3458371,-1
439,1,STEP,992199401661,992202625735,3224074,-1
440,1,STEP,992202698034,992205661610,2963576,-1
441,1,STEP,992205732909,992208336088,2603179,-1
442,1,STEP,992208406587,992211619161,3212574,-1
443,1,STEP,992211689661,992215452330,3762669,-1
444,1,STEP,992215534429,992218778903,3244474,-1
445,1,STEP,992218852002,992221366682,2514680,-1
446,1,STEP,992221438281,992224776854,3338573,-1
447,1,STEP,992224851053,992227682930,2831877,-1
448,1,STEP,992227755630,992230580707,2825077,-1
449,1,STEP,992230653406,992233447183,2793777,-1
450,1,STEP,992233518583,992236261960,2743377,-1
451,1,STEP,992236334160,992239333135,2998975,-1
452,1,STEP,992239406335,992242531309,3124974,-1
453,1,STEP,992242603908,992245593484,2989576,-1
454,1,STEP,992245665383,992248863757,3198374,-1
455,1,STEP,992248937857,992252091731,3153874,-1
456,1,STEP,992252164430,992255111706,2947276,-1
457,1,STEP,992255182706,992258147382,2964676,-1
458,1,STEP,992258220081,992261195157,2975076,-1
459,1,STEP,992261267256,992264504830,3237574,-1
460,1,STEP,992264577829,992267630304,3052475,-1
461,1,STEP,992267702904,992270786879,3083975,-1
462,1,STEP,992270860278,992273813754,2953476,-1
463,1,STEP,992273894153,992277072727,3178574,-1
464,1,STEP,992277145027,992280379700,3234673,-1
465,1,STEP,992280451500,992283995571,3544071,-1
466,1,STEP,992284069070,992287361643,3292573,-1
467,1,STEP,992287435543,992290680716,3245173,-1
468,1,STEP,992290755216,992294241987,3486771,-1
469,1,STEP,992294316287,992297690159,3373872,-1
470,1,STEP,992297762859,992301713026,3950167,-1
471,1,STEP,992301853925,992305932392,4078467,-1
472,1,STEP,992306053891,992309742261,3688370,-1
473,1,STEP,992309856060,992313270932,3414872,-1
474,1,STEP,992313389731,992317109101,3719370,-1
475,1,STEP,992317224000,992320143376,2919376,-1
476,1,STEP,992320260575,992323309150,3048575,-1
477,1,STEP,992323426649,992326690323,3263674,-1
478,1,STEP,992326808222,992330380093,3571871,-1
479,1,STEP,992330496892,992333587166,3090274,-1
480,1,STEP,992333697465,992336613042,2915577,-1
481,1,STEP,992336724141,992339826415,3102274,-1
482,1,STEP,992339941115,992342454894,2513779,-1
483,1,STEP,992342564193,992345499869,2935676,-1
484,1,STEP,992345610568,992348522845,2912277,-1
485,1,STEP,992348633044,992352129715,3496671,-1
486,1,STEP,992352235314,992355018292,2782978,-1
487,1,STEP,992355129991,992358010667,2880676,-1
488,1,STEP,992358125266,992361561338,3436072,-1
489,1,STEP,992361676837,992364947811,3270974,-1
490,1,STEP,992365057010,992368002886,2945876,-1
491,1,STEP,992368113785,992370869662,2755877,-1
492,1,STEP,992370984361,992374435633,3451272,-1
493,1,STEP,992374548732,992377196611,2647879,-1
494,1,STEP,992377307510,992380368785,3061275,-1
495,1,STEP,992380499284,992383670758,3171474,-1
496,1,STEP,992383786757,992387113330,3326573,-1
497,1,STEP,992387229229,992390255904,3026675,-1
498,1,STEP,992390370703,992394271171,3900468,-1
499,1,STEP,992394385770,992397550145,3164375,-1
500,1,STEP,992397664644,992400934017,3269373,-1
501,1,STEP,992401046216,992404043692,2997476,-1
502,1,STEP,992404159291,992407225266,3065975,-1
503,1,STEP,992407339865,992410622138,3282273,-1
504,1,STEP,992410743637,992413830912,3087275,-1
505,1,STEP,992413959611,992416929087,2969476,-1
506,1,STEP,992417044886,992419854363,2809477,-1
507,1,STEP,992419965962,992423072137,3106175,-1
508,1,STEP,992423187736,992426266510,3078774,-1
509,1,STEP,992426379710,992429285486,2905776,-1
510,1,STEP,992429396685,992432300761,2904076,-1
511,1,STEP,992432410260,992435458635,3048375,-1
512,1,STEP,992435613934,992438588510,2974576,-1
513,1,STEP,992438700509,992441418787,2718278,-1
514,1,STEP,992441530286,992444546861,3016575,-1
515,1,STEP,992444660060,992447464838,2804778,-1
516,1,STEP,992447570837,992450803910,3233073,-1
517,1,STEP,992450916409,992453912985,2996576,-1
518,1,STEP,992454028084,992457373957,3345873,-1
519,1,STEP,992457486156,992460644330,3158174,-1
520,1,STEP,992460757229,992464206101,3448872,-1
521,1,STEP,992464320700,992467623473,3302773,-1
522,1,STEP,992467739372,992471210944,3471572,-1
523,1,STEP,992471320843,992474848714,3527871,-1
524,1,STEP,992474973413,992478442585,3469172,-1
525,1,STEP,992478554884,992482058555,3503671,-1
526,1,STEP,992482173354,992485200430,3027076,-1
527,1,STEP,992485311629,992488173006,2861377,-1
528,1,STEP,992488285805,992491060182,2774377,-1
529,1,STEP,992491171381,992494570753,3399372,-1
530,1,STEP,992494687252,992497821927,3134675,-1
531,1,STEP,992497942326,992501311998,3369672,-1
532,1,STEP,992501423697,992504176075,2752378,-1
533,1,STEP,992504287874,992507530648,3242774,-1
534,1,STEP,992507645847,992510411524,2765677,-1
535,1,STEP,992510520323,992513721997,3201674,-1
536,1,STEP,992513834496,992516674273,2839777,-1
537,1,STEP,992516783372,992519463750,2680378,-1
538,1,STEP,992519575649,992523426318,3850669,-1
539,1,STEP,992523540617,992526098596,2557979,-1
540,1,STEP,992526209995,992529093672,2883677,-1
541,1,STEP,992529204471,992532631843,3427372,-1
542,1,STEP,992532743542,992535008624,2265082,-1
543,1,STEP,992535118723,992538213197,3094474,-1
544,1,STEP,992538324696,992541485471,3160775,-1
545,1,STEP,992541596170,992545206240,3610070,-1
546,1,STEP,992545320439,992548045317,2724878,-1
547,1,STEP,992548155016,992551557189,3402173,-1
548,1,STEP,992551645388,992555173459,3528071,-1
549,1,STEP,992555253758,992558678130,3424372,-1
550,1,STEP,992558758830,992562015603,3256773,-1
551,1,STEP,992562096503,992565139178,3042675,-1
552,1,STEP,992565220977,992568155653,2934676,-1
553,1,STEP,992568236753,992571435926,3199173,-1
554,1,STEP,992571514226,992574965298,3451072,-1
555,1,STEP,992575049497,992578392470,3342973,-1
556,1,STEP,992578478169,992581950241,3472072,-1
557,1,STEP,992582067040,992585618311,3551271,-1
558,1,STEP,992585702610,992589300781,3598171,-1
559,1,STEP,992589387680,992592559354,3171674,-1
560,1,STEP,992592687853,992595573730,2885877,-1
561,1,STEP,992595683629,992598473606,2789977,-1
562,1,STEP,992598602405,992601342482,2740077,-1
563,1,STEP,992601432082,992605098352,3666270,-1
564,1,STEP,992605191651,992608709922,3518271,-1
565,1,STEP,992608788922,992611836997,3048075,-1
566,1,STEP,992611913996,992614954271,3040275,-1
567,1,STEP,992615078670,992619760232,4681562,-1
568,1,STEP,992619891731,992624027497,4135766,-1
569,1,STEP,992624151296,992628667660,4516364,-1
570,1,STEP,992628806258,992632782526,3976268,-1
571,1,STEP,992632896425,992636438296,3541871,-1
572,1,STEP,992636552495,992639479871,2927376,-1
573,1,STEP,992639592571,992642687645,3095074,-1
574,1,STEP,992642803844,992646008518,3204674,-1
575,1,STEP,992646132617,992649699388,3566771,-1
576,1,STEP,992649810787,992652713964,2903177,-1
577,1,STEP,992652828363,992656024137,3195774,-1
578,1,STEP,992656139536,992659285210,3145674,-1
579,1,STEP,992659405509,992662528483,3122974,-1
580,1,STEP,992662650282,992665545659,2895377,-1
581,1,STEP,992665658958,992668400536,2741578,-1
582,1,STEP,992668515635,992671842407,3326772,-1
583,1,STEP,992671961407,992674664984,2703577,-1
584,1,STEP,992674776784,992677727759,2950975,-1
585,1,STEP,992677837359,992680867834,3030475,-1
586,1,STEP,992680982833,992684303706,3320873,-1
587,1,STEP,992684417105,992687664278,3247173,-1
588,1,STEP,992687779877,992691289649,3509772,-1
589,1,STEP,992691404648,992694515523,3110875,-1
590,1,STEP,992694630122,992698108793,3478671,-1
591,1,STEP,992698223192,992701689364,3466172,-1
592,1,STEP,992701807963,992705523433,3715470,-1
593,1,STEP,992705642332,992708717707,3075375,-1
594,1,STEP,992708834506,992711493084,2658578,-1
595,1,STEP,992711605983,992714531359,2925376,-1
596,1,STEP,992714654358,992717350236,2695878,-1
597,1,STEP,992717462935,992720390312,2927377,-1
598,1,STEP,992720524210,992723337787,2813577,-1
599,1,STEP,992723451387,992726919058,3467671,-1
600,1,STEP,992727034257,992730269931,3235674,-1
601,1,STEP,992730384530,992733779602,3395072,-1
602,1,STEP,992733905001,992736922377,3017376,-1
603,1,STEP,992737036776,992740228350,3191574,-1
604,1,STEP,992740346649,992743187326,2840677,-1
605,1,STEP,992743305325,992746867696,3562371,-1
606,1,STEP,992746986495,992749899571,2913076,-1
607,1,STEP,992750007870,992753168744,3160874,-1
608,1,STEP,992753281043,992756318618,3037575,-1
609,1,STEP,992756431218,992759516292,3085074,-1
610,1,STEP,992759628291,992762768066,3139775,-1
611,1,STEP,992762879065,992765551543,2672478,-1
612,1,STEP,992765661242,992768552519,2891277,-1
613,1,STEP,992768662118,992771399295,2737177,-1
614,1,STEP,992771510795,992774870167,3359372,-1
615,1,STEP,992774981866,992778025041,3043175,-1
616,1,STEP,992778135841,992780955318,2819477,-1
617,1,STEP,992781063617,992783675295,2611678,-1
618,1,STEP,992783786094,992786910569,3124475,-1
619,1,STEP,992787022068,992790234142,3212074,-1
620,1,STEP,992790347341,992793444916,3097575,-1
621,1,STEP,992793556915,992796371592,2814677,-1
622,1,STEP,992796482991,992799354967,2871976,-1
623,1,STEP,992799468267,992802658041,3189774,-1
624,1,STEP,992802777340,992806127412,3350072,-1
625,1,STEP,992806240711,992810791974,4551263,-1
626,1,STEP,992810899873,992814021948,3122075,-1
627,1,STEP,992814137447,992817440220,3302773,-1
628,1,STEP,992817554419,992821456687,3902268,-1
629,1,STEP,992821577786,992824720861,3143075,-1
630,1,STEP,992824842160,992828462330,3620170,-1
631,1,STEP,992828577429,992831518605,2941176,-1
632,1,STEP,992831636204,992834666979,3030775,-1
633,1,STEP,992834779379,992837837254,3057875,-1
634,1,STEP,992837961753,992840968428,3006675,-1
635,1,STEP,992841079227,992844047003,2967776,-1
636,1,STEP,992844156902,992846665482,2508580,-1
637,1,STEP,992846776281,992850310552,3534271,-1
638,1,STEP,992850427451,992853663125,3235674,-1
639,1,STEP,992853775924,992856551901,2775977,-1
640,1,STEP,992856668900,992859617376,2948476,-1
641,1,STEP,992859734775,992862857850,3123075,-1
642,1,STEP,992862979249,992865947324,2968075,-1
643,1,STEP,992866061323,992869020399,2959076,-1
644,1,STEP,992869133598,992872392072,3258474,-1
645,1,STEP,992872505271,992875826644,3321373,-1
646,1,STEP,992875943043,992879406015,3462972,-1
647,1,STEP,992879521214,992883111684,3590470,-1
648,1,STEP,992883225383,992886393158,3167775,-1
649,1,STEP,992886507757,992890274826,3767069,-1
650,1,STEP,992890393825,992893540199,3146374,-1
651,1,STEP,992893654798,992896524975,2870177,-1
652,1,STEP,992896639374,992899972847,3333473,-1
653,1,STEP,992900087146,992902916123,2828977,-1
654,1,STEP,992903033122,992906326095,3292973,-1
655,1,STEP,992906439994,992909849966,3409972,-1
656,1,STEP,992909974165,992913202039,3227874,-1
657,1,STEP,992913316838,992916528812,3211974,-1
658,1,STEP,992916643511,992919454288,2810777,-1
659,1,STEP,992919571187,992923096558,3525371,-1
660,1,STEP,992923212357,992926731329,3518972,-1
661,1,STEP,992926846928,992930334999,3488071,-1
662,1,STEP,992930451898,992933625672,3173774,-1
663,1,STEP,992933736371,992937162143,3425772,-1
664,1,STEP,992937275643,992940472216,3196573,-1
665,1,STEP,992940587616,992945306077,4718461,-1
666,1,STEP,992945382676,992948534551,3151875,-1
667,1,STEP,992948609950,992951748625,3138675,-1
668,1,STEP,992951822924,992954743600,2920676,-1
669,1,STEP,992954817699,992957479478,2661779,-1
670,1,STEP,992957551677,992961443145,3891468,-1
671,1,STEP,992961518845,992964998516,3479671,-1
672,1,STEP,992965072316,992968414689,3342373,-1
673,1,STEP,992968488288,992971435664,2947376,-1
674,1,STEP,992971510163,992974491339,2981176,-1
675,1,STEP,992974565338,992977861312,3295974,-1
676,1,STEP,992977951311,992980846487,2895176,-1
677,1,STEP,992980919587,992984171260,3251673,-1
678,1,STEP,992984246159,992987024137,2777978,-1
679,1,STEP,992987125936,992990849106,3723170,-1
680,1,STEP,992990942405,992994529976,3587571,-1
681,1,STEP,992994628775,992997834549,3205774,-1
682,1,STEP,992997934048,993001408919,3474871,-1
683,1,STEP,993001507419,993004763692,3256273,-1
684,1,STEP,993004858791,993007888867,3030076,-1
685,1,STEP,993007974366,993011401338,3426972,-1
686,1,STEP,993011494537,993014338214,2843677,-1
687,1,STEP,993014424213,993017845385,3421172,-1
688,1,STEP,993017966584,993020852561,2885977,-1
689,1,STEP,993020939860,993024196734,3256874,-1
690,1,STEP,993024288233,993027240809,2952576,-1
691,1,STEP,993027335208,993030455383,3120175,-1
692,1,STEP,993030544382,993034439650,3895268,-1
693,1,STEP,993034531149,993037146228,2615079,-1
694,1,STEP,993037228627,993040058904,2830277,-1
695,1,STEP,993040151603,993042924181,2772578,-1
696,1,STEP,993043017480,993045578359,2560879,-1
697,1,STEP,993045664659,993048411836,2747177,-1
698,1,STEP,993048500635,993051560110,3059475,-1
699,1,STEP,993051648310,993054916483,3268173,-1
700,1,STEP,993055009082,993058165257,3156175,-1
701,1,STEP,993058259256,993061409730,3150474,-1
702,1,STEP,993061502029,993065001301,3499272,-1
703,1,STEP,993065096200,993067815578,2719378,-1
704,1,STEP,993067913277,993071098851,3185574,-1
705,1,STEP,993071192350,993073878728,2686378,-1
706,1,STEP,993073977728,993076535707,2557979,-1
707,1,STEP,993076627306,993079593982,2966676,-1
708,1,STEP,993079685981,993082769656,3083675,-1
709,1,STEP,993082862755,993086011929,3149174,-1
710,1,STEP,993086108929,993089339602,3230673,-1
711,1,STEP,993089433002,993092192079,2759077,-1
712,1,STEP,993092283378,993095540652,3257274,-1
713,1,STEP,993095670951,993099724618,4053667,-1
714,1,STEP,993099800917,993102745093,2944176,-1
715,1,STEP,993102822892,993105977967,3155075,-1
716,1,STEP,993106052466,993109102241,3049775,-1
717,1,STEP,993109213240,993112023017,2809777,-1
718,1,STEP,993112138316,993114952993,2814677,-1
719,1,STEP,993115067992,993118169667,3101675,-1
720,1,STEP,993118285266,993121626339,3341073,-1
721,1,STEP,993121739838,993124866413,3126575,-1
722,1,STEP,993124981312,993128657682,3676370,-1
723,1,STEP,993128769481,993131850056,3080575,-1
724,1,STEP,993131976055,993135697624,3721569,-1
725,1,STEP,993135773924,993139100196,3326272,-1
726,1,STEP,993139175396,993142385870,3210474,-1
727,1,STEP,993142461269,993145610343,3149074,-1
728,1,STEP,993145682243,993148679418,2997175,-1
729,1,STEP,993148751018,993152163390,3412372,-1
730,1,STEP,993152235589,993155886860,3651271,-1
731,1,STEP,993155960159,993159461330,3501171,-1
732,1,STEP,993159537030,993162341707,2804677,-1
733,1,STEP,993162416606,993165239483,2822877,-1
734,1,STEP,993165310283,993167899162,2588879,-1
735,1,STEP,993167971361,993170638539,2667178,-1
736,1,STEP,993170710539,993173917912,3207373,-1
737,1,STEP,993173992012,993176705690,2713678,-1
738,1,STEP,993176777189,993179637966,2860777,-1
739,1,STEP,993179711065,993182815540,3104475,-1
740,1,STEP,993182889139,993185634517,2745378,-1
741,1,STEP,993185705016,993188461594,2756578,-1
742,1,STEP,993188533493,993191656068,3122575,-1
743,1,STEP,993191727467,993195416137,3688670,-1
744,1,STEP,993195506236,993198606211,3099975,-1
745,1,STEP,993198681310,993202123982,3442672,-1
746,1,STEP,993202213182,993205532855,3319673,-1
747,1,STEP,993205606254,993208174133,2567879,-1
748,1,STEP,993208245732,993211407007,3161275,-1
749,1,STEP,993211479506,993213923686,2444180,-1
750,1,STEP,993213995386,993217135360,3139974,-1
751,1,STEP,993217206959,993220381533,3174574,-1
752,1,STEP,993220454333,993223424909,2970576,-1
753,1,STEP,993223498408,993226036987,2538579,-1
754,1,STEP,993226109987,993229374660,3264673,-1
755,1,STEP,993229446660,993232070538,2623878,-1
756,1,STEP,993232141238,993235163713,3022475,-1
757,1,STEP,993235235812,993238015890,2780078,-1
758,1,STEP,993238088789,993241333163,3244374,-1
759,1,STEP,993241404562,993244636036,3231474,-1
760,1,STEP,993244706535,993247303614,2597079,-1
761,1,STEP,993247376213,993250679786,3303573,-1
762,1,STEP,993250752886,993253711962,2959076,-1
763,1,STEP,993253783061,993256617038,2833977,-1
764,1,STEP,993256743337,993260125409,3382072,-1
765,1,STEP,993260257608,993263341783,3084175,-1
766,1,STEP,993263429182,993266536057,3106875,-1
767,1,STEP,993266621356,993270180827,3559471,-1
768,1,STEP,993270315526,993274017296,3701770,-1
769,1,STEP,993274144295,993276805273,2660978,-1
770,1,STEP,993276928672,993280311945,3383273,-1
771,1,STEP,993280443444,993283569918,3126474,-1
772,1,STEP,993283686917,993286654693,2967776,-1
773,1,STEP,993286767392,993290413362,3645970,-1
774,1,STEP,993290524861,993293504937,2980076,-1
775,1,STEP,993293614736,993296749111,3134375,-1
776,1,STEP,993296865710,993300270482,3404772,-1
777,1,STEP,993300386981,993303383056,2996075,-1
778,1,STEP,993303495856,993306591530,3095674,-1
779,1,STEP,993306704929,993310040502,3335573,-1
780,1,STEP,993310154801,993312823679,2668878,-1
781,1,STEP,993312935479,993315389259,2453780,-1
782,1,STEP,993315501958,993318716931,3214973,-1
783,1,STEP,993318831430,993321781806,2950376,-1
784,1,STEP,993321907705,993324723182,2815477,-1
785,1,STEP,993324838182,993328000256,3162074,-1
786,1,STEP,993328112555,993331270329,3157774,-1
787,1,STEP,993331383128,993334047506,2664378,-1
788,1,STEP,993334161105,993337522578,3361473,-1
789,1,STEP,993337635577,993340848451,3212874,-1
790,1,STEP,993340962950,993344513221,3550271,-1
791,1,STEP,993344628820,993347814494,3185674,-1
792,1,STEP,993347933493,993351305866,3372373,-1
793,1,STEP,993351415565,993354665338,3249773,-1
794,1,STEP,993354779237,993358290509,3511272,-1
795,1,STEP,993358406308,993361584382,3178074,-1
796,1,STEP,993361695781,993365197152,3501371,-1
797,1,STEP,993365308251,993368031329,2723078,-1
798,1,STEP,993368141728,993371486601,3344873,-1
799,1,STEP,993371602000,993374589976,2987976,-1
800,1,STEP,993374703175,993377617151,2913976,-1
801,1,STEP,993377730050,993381226022,3495972,-1
802,1,STEP,993381342321,993384004099,2661778,-1
803,1,STEP,993384122998,993387881767,3758769,-1
804,1,STEP,993387995566,993391694536,3698970,-1
805,1,STEP,993391808735,993394651312,2842577,-1
806,1,STEP,993394764511,993398120484,3355973,-1
807,1,STEP,993398233383,993401405757,3172374,-1
808,1,STEP,993401519456,993404355133,2835677,-1
809,1,STEP,993404469932,993407469208,2999276,-1
810,1,STEP,993407582507,993410282085,2699578,-1
811,1,STEP,993410400584,993413595058,3194474,-1
812,1,STEP,993413711457,993417125129,3413672,-1
813,1,STEP,993417239428,993420310503,3071075,-1
814,1,STEP,993420430202,993423427277,2997075,-1
815,1,STEP,993423543676,993427376945,3833269,-1
816,1,STEP,993427492244,993431327113,3834869,-1
817,1,STEP,993431442312,993434842684,3400372,-1
818,1,STEP,993434960083,993438210057,3249974,-1
819,1,STEP,993438323756,993441487530,3163774,-1
820,1,STEP,993441600629,993444498206,2897577,-1
821,1,STEP,993444615505,993447760879,3145374,-1
822,1,STEP,993447851378,993450744355,2892977,-1
823,1,STEP,993450828754,993454121427,3292673,-1
824,1,STEP,993454206026,993456802105,2596079,-1
825,1,STEP,993456884905,993459741881,2856976,-1
826,1,STEP,993459825281,993463159853,3334572,-1
827,1,STEP,993463242653,993465996730,2754077,-1
828,1,STEP,993466119829,993469268104,3148275,-1
829,1,STEP,993469341703,993472302179,2960476,-1
830,1,STEP,993472373978,993475163555,2789577,-1
831,1,STEP,993475256455,993478069232,2812777,-1
832,1,STEP,993478153131,993481220806,3067675,-1
833,1,STEP,993481300505,993484327481,3026976,-1
834,1,STEP,993484411480,993487514255,3102775,-1
835,1,STEP,993487597754,993490497130,2899376,-1
836,1,STEP,993490584930,993494150901,3565971,-1
837,1,STEP,993494235000,993497190376,2955376,-1
838,1,STEP,993497272875,993499989353,2716478,-1
839,1,STEP,993500071052,993502715531,2644479,-1
840,1,STEP,993502797630,993505683506,2885876,-1
841,1,STEP,993505764906,993508751081,2986175,-1
842,1,STEP,993508833481,993511644858,2811377,-1
843,1,STEP,993511730057,993515064430,3334373,-1
844,1,STEP,993515148329,993518359403,3211074,-1
845,1,STEP,993518441902,993521679876,3237974,-1
846,1,STEP,993521761875,993525128848,3366973,-1
847,1,STEP,993525212647,993528599020,3386373,-1
848,1,STEP,993528685219,993531979692,3294473,-1
849,1,STEP,993532063191,993535616962,3553771,-1
850,1,STEP,993535704562,993538487839,2783277,-1
851,1,STEP,993538570538,993541964311,3393773,-1
852,1,STEP,993542050910,993545901078,3850168,-1
853,1,STEP,993545986378,993549215951,3229573,-1
854,1,STEP,993549307151,993552088528,2781377,-1
855,1,STEP,993552193927,993555154703,2960776,-1
856,1,STEP,993555243602,993558099379,2855777,-1
857,1,STEP,993558182478,993561267953,3085475,-1
858,1,STEP,993561350152,993564795424,3445272,-1
859,1,STEP,993564879324,993568193497,3314173,-1
860,1,STEP,993568279896,993571544569,3264673,-1
861,1,STEP,993571628969,993574838142,3209173,-1
862,1,STEP,993574920442,993578361014,3440572,-1
863,1,STEP,993578446313,993581877185,3430872,-1
864,1,STEP,993581965084,993585193658,3228574,-1
865,1,STEP,993585277257,993588805429,3528172,-1
866,1,STEP,993588893728,993592066602,3172874,-1
867,1,STEP,993592139801,993595351475,3211674,-1
868,1,STEP,993595425475,993598566549,3141074,-1
869,1,STEP,993598652348,993602224419,3572071,-1
870,1,STEP,993602299218,993605376393,3077175,-1
871,1,STEP,993605451293,993608207870,2756577,-1
872,1,STEP,993608280170,993611469144,3188974,-1
873,1,STEP,993611542743,993614541019,2998276,-1
874,1,STEP,993614613418,993617393595,2780177,-1
875,1,STEP,993617464795,993620533170,3068375,-1
876,1,STEP,993620606469,993623597045,2990576,-1
877,1,STEP,993623683744,993627649012,3965268,-1
878,1,STEP,993627725511,993631091484,3365973,-1
879,1,STEP,993631165683,993634090359,2924676,-1
880,1,STEP,993634162259,993637564631,3402372,-1
881,1,STEP,993637637930,993640336408,2698478,-1
882,1,STEP,993640409208,993642961387,2552179,-1
883,1,STEP,993643032686,993645863263,2830577,-1
884,1,STEP,993645974862,993648826439,2851577,-1
885,1,STEP,993648903738,993652438010,3534272,-1
886,1,STEP,993652513209,993655449485,2936276,-1
887,1,STEP,993655522584,993658804458,3281874,-1
888,1,STEP,993658878657,993661559835,2681178,-1
889,1,STEP,993661631735,993664967707,3335972,-1
890,1,STEP,993665041607,993668023082,2981475,-1
891,1,STEP,993668093182,993671447254,3354072,-1
892,1,STEP,993671553854,993674746228,3192374,-1
893,1,STEP,993674864527,993677303307,2438780,-1
894,1,STEP,993677420006,993680426181,3006175,-1
895,1,STEP,993680542780,993683401457,2858677,-1
896,1,STEP,993683516056,993686780729,3264673,-1
897,1,STEP,993686895628,993690138702,3243074,-1
898,1,STEP,993690251201,993693017579,2766378,-1
899,1,STEP,993693130078,993696690849,3560771,-1
900,1,STEP,993696804448,993699415326,2610878,-1
901,1,STEP,993699525925,993702746399,3220474,-1
902,1,STEP,993702857498,993705768975,2911477,-1
903,1,STEP,993705894774,993709431945,3537171,-1
904,1,STEP,993709546844,993712771617,3224773,-1
905,1,STEP,993712885017,993715708093,2823076,-1
906,1,STEP,993715823493,993718761669,2938176,-1
907,1,STEP,993718876168,993722128441,3252273,-1
908,1,STEP,993722239540,993724999018,2759478,-1
909,1,STEP,993725109717,993727768395,2658678,-1
910,1,STEP,993727880094,993730600172,2720078,-1
911,1,STEP,993730716471,993734197543,3481072,-1
912,1,STEP,993734313842,993736757622,2443780,-1
913,1,STEP,993736868121,993739938696,3070575,-1
914,1,STEP,993740064195,993743149870,3085675,-1
915,1,STEP,993743263369,993746378343,3114974,-1
916,1,STEP,993746492942,993749054821,2561879,-1
917,1,STEP,993749163321,993751731400,2568079,-1
918,1,STEP,993751843999,993754812175,2968176,-1
919,1,STEP,993754925474,993758205347,3279873,-1
920,1,STEP,993758321146,993761564419,3243273,-1
921,1,STEP,993761676019,993765113691,3437672,-1
922,1,STEP,993765225890,993767957867,2731977,-1
923,1,STEP,993768070266,993771414639,3344373,-1
924,1,STEP,993771532138,993774120617,2588479,-1
925,1,STEP,993774233116,993777560089,3326973,-1
926,1,STEP,993777673188,993780764263,3091075,-1
927,1,STEP,993780877162,993783495841,2618679,-1
928,1,STEP,993783610940,993786307218,2696278,-1
929,1,STEP,993786419917,993789491292,3071375,-1
930,1,STEP,993789604791,993792543867,2939076,-1
931,1,STEP,993792658566,993795371844,2713278,-1
932,1,STEP,993795486443,993798949815,3463372,-1
933,1,STEP,993799065014,993802276787,3211773,-1
934,1,STEP,993802391186,993805607060,3215874,-1
935,1,STEP,993805719659,993809382029,3662370,-1
936,1,STEP,993809499229,993812906701,3407472,-1
937,1,STEP,993813020200,993815920276,2900076,-1
938,1,STEP,993816037275,993819399948,3362673,-1
939,1,STEP,993819523247,993822195525,2672278,-1
940,1,STEP,993822310424,993825387999,3077575,-1
941,1,STEP,993825500898,993828465474,2964576,-1
942,1,STEP,993828580773,993831366750,2785977,-1
943,1,STEP,993831481049,993834361426,2880377,-1
944,1,STEP,993834476425,993837534600,3058175,-1
945,1,STEP,993837647699,993840991472,3343773,-1
946,1,STEP,993841103571,993844586842,3483271,-1
947,1,STEP,993844701441,993847778316,3076875,-1
948,1,STEP,993847885115,993850247896,2362781,-1
949,1,STEP,993850358295,993854057465,3699170,-1
950,1,STEP,993854173564,993857525937,3352373,-1
951,1,STEP,993857638336,993860664811,3026475,-1
952,1,STEP,993860779010,993864185682,3406672,-1
953,1,STEP,993864299782,993866724662,2424880,-1
954,1,STEP,993866841561,993870086134,3244573,-1
955,1,STEP,993870200033,993873080610,2880577,-1
956,1,STEP,993873193409,993876881879,3688470,-1
957,1,STEP,993877000078,993880224452,3224374,-1
958,1,STEP,993880335251,993883306527,2971276,-1
959,1,STEP,993883421926,993886303902,2881976,-1
960,1,STEP,993886418901,993889512476,3093575,-1
961,1,STEP,993889625375,993893143946,3518571,-1
962,1,STEP,993893258445,993896484819,3226374,-1
963,1,STEP,993896598518,993899484995,2886477,-1
964,1,STEP,993899600094,993902678169,3078075,-1
965,1,STEP,993902791868,993906315239,3523371,-1
966,1,STEP,993906434238,993909454713,3020475,-1
967,1,STEP,993909566712,993912404389,2837677,-1
968,1,STEP,993912519988,993915547964,3027976,-1
969,1,STEP,993915659263,993918214342,2555079,-1
970,1,STEP,993918329641,993920985419,2655778,-1
971,1,STEP,993921100518,993924025194,2924676,-1
972,1,STEP,993924143093,993927138769,2995676,-1
973,1,STEP,993927255968,993930160644,2904676,-1
974,1,STEP,993930276343,993933241219,2964876,-1
975,1,STEP,993933353518,993936407593,3054075,-1
976,1,STEP,993936523592,993939663767,3140175,-1
977,1,STEP,993939778566,993942548143,2769577,-1
978,1,STEP,993942666342,993945797317,3130975,-1
979,1,STEP,993945923216,993949113590,3190374,-1
980,1,STEP,993949228389,993952383163,3154774,-1
981,1,STEP,993952495262,993955295039,2799777,-1
982,1,STEP,993955419138,993958491113,3071975,-1
983,1,STEP,993958606512,993961811686,3205174,-1
984,1,STEP,993961940285,993964963261,3022976,-1
985,1,STEP,993965078960,993968137635,3058675,-1
986,1,STEP,993968253934,993970893412,2639478,-1
987,1,STEP,993971006011,993974285584,3279573,-1
988,1,STEP,993974396284,993977465359,3069075,-1
989,1,STEP,993977577458,993980548933,2971475,-1
990,1,STEP,993980665232,993983176812,2511580,-1
991,1,STEP,993983288111,993986288587,3000476,-1
992,1,STEP,993986404486,993989288662,2884176,-1
993,1,STEP,993989398861,993992414037,3015176,-1
994,1,STEP,993992528136,993995215814,2687678,-1
995,1,STEP,993995328013,993998867784,3539771,-1
996,1,STEP,993998979583,994001860360,2880777,-1
997,1,STEP,994001990758,994005079533,3088775,-1
998,1,STEP,994005192832,994008227508,3034676,-1
999,1,STEP,994008339407,994011457681,3118274,-1
