Gen,Resource,Stamp,TimeStamp_Start,TimeStamp_End,Duration,Indiv_id
0,1,FirstEvaluation,756929422930,757733197104,803774174,-1
0,1,STEP,757733364702,757739235624,5870922,-1
1,1,STEP,757739313123,757743692464,4379341,-1
2,1,STEP,757743761463,757748520400,4758937,-1
3,1,STEP,757748593199,757752700244,4107045,-1
4,1,STEP,757752771943,757756132798,3360855,-1
5,1,STEP,757756201497,757760714637,4513140,-1
6,1,STEP,757760784136,757766411961,5627825,-1
7,1,STEP,757766486260,757770657205,4170945,-1
8,1,STEP,757770730304,757774163858,3433554,-1
9,1,STEP,757774233657,757779032193,4798536,-1
10,1,STEP,757779102892,757782586045,3483153,-1
11,1,STEP,757782654744,757787354282,4699538,-1
12,1,STEP,757787424581,757792244617,4820036,-1
13,1,STEP,757792314716,757796386661,4071945,-1
14,1,STEP,757796456360,757800540606,4084246,-1
15,1,STEP,757800609705,757803790762,3181057,-1
16,1,STEP,757803860162,757807860108,3999946,-1
17,1,STEP,757807928807,757811949254,4020447,-1
18,1,STEP,757812018453,757815482606,3464153,-1
19,1,STEP,757815550906,757818561365,3010459,-1
20,1,STEP,757818630764,757822722810,4092046,-1
21,1,STEP,757822792409,757826261563,3469154,-1
22,1,STEP,757826329662,757829279722,2950060,-1
23,1,STEP,757829344521,757833182170,3837649,-1
24,1,STEP,757833251569,757837415514,4163945,-1
25,1,STEP,757837484413,757841328462,3844049,-1
26,1,STEP,757841399761,757845490006,4090245,-1
27,1,STEP,757845560205,757849570952,4010747,-1
28,1,STEP,757849640051,757853109704,3469653,-1
29,1,STEP,757853177603,757857812242,4634639,-1
30,1,STEP,757857905640,757861702790,3797150,-1
31,1,STEP,757861774689,757865437940,3663251,-1
32,1,STEP,757865513939,757869315388,3801449,-1
33,1,STEP,757869383987,757872655444,3271457,-1
34,1,STEP,757872726843,757876190996,3464153,-1
35,1,STEP,757876257995,757879430953,3172958,-1
36,1,STEP,757879499252,757882948406,3449154,-1
37,1,STEP,757883019905,757886023365,3003460,-1
38,1,STEP,757886091164,757888843227,2752063,-1
39,1,STEP,757888911427,757891904787,2993360,-1
40,1,STEP,757891973186,757895212143,3238957,-1
41,1,STEP,757895281942,757898526598,3244656,-1
42,1,STEP,757898593897,757902309648,3715751,-1
43,1,STEP,757902379447,757905372007,2992560,-1
44,1,STEP,757905439706,757908489065,3049359,-1
45,1,STEP,757908558264,757911953919,3395655,-1
46,1,STEP,757912026118,757914988179,2962061,-1
47,1,STEP,757915051178,757917800341,2749163,-1
48,1,STEP,757917878840,757920805901,2927061,-1
49,1,STEP,757920876200,757923654363,2778163,-1
50,1,STEP,757923723762,757927251715,3527953,-1
51,1,STEP,757927340314,757930986365,3646051,-1
52,1,STEP,757931077764,757934679116,3601352,-1
53,1,STEP,757934755415,757937964672,3209257,-1
54,1,STEP,757938038271,757941727222,3688951,-1
55,1,STEP,757941800321,757945335174,3534853,-1
56,1,STEP,757945410373,757948807327,3396954,-1
57,1,STEP,757948879026,757951696889,2817863,-1
58,1,STEP,757951769588,757954367953,2598365,-1
59,1,STEP,757954439952,757957030418,2590466,-1
60,1,STEP,757957103117,757959931479,2828362,-1
61,1,STEP,757960002378,757963182935,3180557,-1
62,1,STEP,757963256435,757966063097,2806662,-1
63,1,STEP,757966132296,757969268054,3135758,-1
64,1,STEP,757969338953,757972878006,3539053,-1
65,1,STEP,757972949505,757976490958,3541453,-1
66,1,STEP,757976562657,757978906426,2343769,-1
67,1,STEP,757978976425,757981962685,2986260,-1
68,1,STEP,757982035484,757984855746,2820262,-1
69,1,STEP,757984926945,757987569810,2642865,-1
70,1,STEP,757987641409,757990132576,2491167,-1
71,1,STEP,757990204775,757993099036,2894261,-1
72,1,STEP,757993169735,757996299294,3129559,-1
73,1,STEP,757996371293,757999703648,3332355,-1
74,1,STEP,757999776347,758002839106,3062759,-1
75,1,STEP,758002910605,758005942865,3032260,-1
76,1,STEP,758006014064,758008633829,2619765,-1
77,1,STEP,758008703128,758011506091,2802963,-1
78,1,STEP,758011577390,758014401052,2823662,-1
79,1,STEP,758014473251,758017152515,2679264,-1
80,1,STEP,758017225314,758020159775,2934461,-1
81,1,STEP,758020231474,758022840039,2608565,-1
82,1,STEP,758022911538,758025819700,2908162,-1
83,1,STEP,758025915898,758028677462,2761564,-1
84,1,STEP,758028748461,758031729621,2981160,-1
85,1,STEP,758031810620,758034596983,2786363,-1
86,1,STEP,758034667582,758037637842,2970260,-1
87,1,STEP,758037709541,758040627302,2917761,-1
88,1,STEP,758040697201,758043511264,2814063,-1
89,1,STEP,758043583763,758046279527,2695764,-1
90,1,STEP,758046350626,758049479984,3129358,-1
91,1,STEP,758049552283,758052875839,3323556,-1
92,1,STEP,758052948738,758056120295,3171557,-1
93,1,STEP,758056193294,758058682061,2488767,-1
94,1,STEP,758058751260,758061474924,2723664,-1
95,1,STEP,758061546823,758064693281,3146458,-1
96,1,STEP,758064765980,758067588542,2822562,-1
97,1,STEP,758067661541,758070488704,2827163,-1
98,1,STEP,758070562203,758073314966,2752763,-1
99,1,STEP,758073387465,758076402625,3015160,-1
100,1,STEP,758076474824,758079041289,2566465,-1
101,1,STEP,758079112089,758081907351,2795262,-1
102,1,STEP,758081979050,758084888311,2909261,-1
103,1,STEP,758084960410,758087634575,2674165,-1
104,1,STEP,758087706374,758090324539,2618165,-1
105,1,STEP,758090395738,758093592495,3196757,-1
106,1,STEP,758093663994,758096657154,2993160,-1
107,1,STEP,758096726853,758099548516,2821663,-1
108,1,STEP,758099617515,758102902371,3284856,-1
109,1,STEP,758102976770,758105930531,2953761,-1
110,1,STEP,758106003430,758109002590,2999160,-1
111,1,STEP,758109072589,758112043349,2970760,-1
112,1,STEP,758112115148,758114867211,2752063,-1
113,1,STEP,758114940510,758117559075,2618565,-1
114,1,STEP,758117630275,758120672034,3041759,-1
115,1,STEP,758120746033,758123444497,2698464,-1
116,1,STEP,758123518296,758126662854,3144558,-1
117,1,STEP,758126736353,758129809612,3073259,-1
118,1,STEP,758129903911,758133327165,3423254,-1
119,1,STEP,758133401764,758136721620,3319856,-1
120,1,STEP,758136794519,758140189773,3395254,-1
121,1,STEP,758140259473,758143549829,3290356,-1
122,1,STEP,758143621728,758146648687,3026959,-1
123,1,STEP,758146722486,758149639947,2917461,-1
124,1,STEP,758149712046,758152828805,3116759,-1
125,1,STEP,758152904004,758155669767,2765763,-1
126,1,STEP,758155740766,758158669927,2929161,-1
127,1,STEP,758158744126,758162123681,3379555,-1
128,1,STEP,758162222179,758165397437,3175258,-1
129,1,STEP,758165472136,758168486096,3013960,-1
130,1,STEP,758168560595,758171320058,2759463,-1
131,1,STEP,758171392057,758174281119,2889062,-1
132,1,STEP,758174390717,758177214879,2824162,-1
133,1,STEP,758177331478,758180249139,2917661,-1
134,1,STEP,758180363137,758183728692,3365555,-1
135,1,STEP,758183843191,758186923850,3080659,-1
136,1,STEP,758187035948,758189865811,2829863,-1
137,1,STEP,758189996409,758193553061,3556652,-1
138,1,STEP,758193661160,758197051215,3390055,-1
139,1,STEP,758197166913,758200208173,3041260,-1
140,1,STEP,758200321571,758203559128,3237557,-1
141,1,STEP,758203673626,758206932783,3259157,-1
142,1,STEP,758207045981,758210841231,3795250,-1
143,1,STEP,758210955829,758214005688,3049859,-1
144,1,STEP,758214118387,758216574554,2456167,-1
145,1,STEP,758216685053,758220414203,3729150,-1
146,1,STEP,758220528401,758223413163,2884762,-1
147,1,STEP,758223526761,758226339524,2812763,-1
148,1,STEP,758226451922,758229389483,2937561,-1
149,1,STEP,758229500382,758232896836,3396454,-1
150,1,STEP,758233009135,758236162093,3152958,-1
151,1,STEP,758236273491,758239658946,3385455,-1
152,1,STEP,758239769945,758242953602,3183657,-1
153,1,STEP,758243069801,758245747665,2677864,-1
154,1,STEP,758245858563,758248815024,2956461,-1
155,1,STEP,758248926422,758252151779,3225357,-1
156,1,STEP,758252263078,758254886943,2623865,-1
157,1,STEP,758254994742,758258125500,3130758,-1
158,1,STEP,758258239198,758261746551,3507353,-1
159,1,STEP,758261857550,758264999408,3141858,-1
160,1,STEP,758265111507,758268661559,3550052,-1
161,1,STEP,758268772658,758272039914,3267256,-1
162,1,STEP,758272154113,758275345270,3191157,-1
163,1,STEP,758275455968,758278293731,2837763,-1
164,1,STEP,758278403629,758281585987,3182358,-1
165,1,STEP,758281696285,758284717745,3021460,-1
166,1,STEP,758284829543,758287794204,2964661,-1
167,1,STEP,758287905202,758290943762,3038560,-1
168,1,STEP,758291055360,758294254918,3199558,-1
169,1,STEP,758294366516,758297216878,2850362,-1
170,1,STEP,758297331777,758300253038,2921261,-1
171,1,STEP,758300373436,758303463595,3090159,-1
172,1,STEP,758303576093,758306273457,2697364,-1
173,1,STEP,758306383956,758309519514,3135558,-1
174,1,STEP,758309630512,758312821170,3190658,-1
175,1,STEP,758312933568,758315746331,2812763,-1
176,1,STEP,758315857529,758319181685,3324156,-1
177,1,STEP,758319294483,758322457741,3163258,-1
178,1,STEP,758322571540,758325206705,2635165,-1
179,1,STEP,758325318103,758328811356,3493253,-1
180,1,STEP,758328925655,758331782417,2856762,-1
181,1,STEP,758331892515,758334768777,2876262,-1
182,1,STEP,758334843276,758337615139,2771863,-1
183,1,STEP,758337686738,758340575000,2888262,-1
184,1,STEP,758340646899,758344010854,3363955,-1
185,1,STEP,758344084353,758347344009,3259656,-1
186,1,STEP,758347417308,758349919975,2502667,-1
187,1,STEP,758349990574,758352904835,2914261,-1
188,1,STEP,758352976434,758355917095,2940661,-1
189,1,STEP,758355988394,758358525160,2536766,-1
190,1,STEP,758358596659,758361274923,2678264,-1
191,1,STEP,758361343922,758364322683,2978761,-1
192,1,STEP,758364395982,758366962947,2566965,-1
193,1,STEP,758367034246,758369962707,2928461,-1
194,1,STEP,758370035606,758372789570,2753964,-1
195,1,STEP,758372861069,758375717131,2856062,-1
196,1,STEP,758375785230,758379321382,3536152,-1
197,1,STEP,758379395181,758382121245,2726064,-1
198,1,STEP,758382193444,758385170904,2977460,-1
199,1,STEP,758385243403,758388352862,3109459,-1
200,1,STEP,758388424961,758391281323,2856362,-1
201,1,STEP,758391355122,758394292583,2937461,-1
202,1,STEP,758394367682,758397486140,3118458,-1
203,1,STEP,758397557139,758400358702,2801563,-1
204,1,STEP,758400430301,758403685757,3255456,-1
205,1,STEP,758403758656,758406737817,2979161,-1
206,1,STEP,758406809716,758410482867,3673151,-1
207,1,STEP,758410556766,758413534226,2977460,-1
208,1,STEP,758413605525,758416430887,2825362,-1
209,1,STEP,758416502986,758419585645,3082659,-1
210,1,STEP,758419657744,758422162811,2505067,-1
211,1,STEP,758422234910,758425315369,3080459,-1
212,1,STEP,758425387868,758428549626,3161758,-1
213,1,STEP,758428620525,758432103478,3482953,-1
214,1,STEP,758432176477,758435475533,3299056,-1
215,1,STEP,758435548332,758438294396,2746064,-1
216,1,STEP,758438365295,758441777549,3412254,-1
217,1,STEP,758441850448,758444863308,3012860,-1
218,1,STEP,758444935707,758448158064,3222357,-1
219,1,STEP,758448231363,758451035526,2804163,-1
220,1,STEP,758451106725,758454527079,3420354,-1
221,1,STEP,758454602078,758457493939,2891861,-1
222,1,STEP,758457566038,758461172190,3606152,-1
223,1,STEP,758461246489,758464637644,3391155,-1
224,1,STEP,758464711743,758467926300,3214557,-1
225,1,STEP,758467999399,758471091158,3091759,-1
226,1,STEP,758471165657,758474069718,2904061,-1
227,1,STEP,758474146017,758477173577,3027560,-1
228,1,STEP,758477248176,758480036039,2787863,-1
229,1,STEP,758480110338,758483017699,2907361,-1
230,1,STEP,758483093198,758486333554,3240356,-1
231,1,STEP,758486407653,758489383614,2975961,-1
232,1,STEP,758489454713,758491926580,2471867,-1
233,1,STEP,758491998179,758495028138,3029959,-1
234,1,STEP,758495102037,758497763102,2661065,-1
235,1,STEP,758497834801,758501604151,3769350,-1
236,1,STEP,758501680650,758504523812,2843162,-1
237,1,STEP,758504595711,758507993265,3397554,-1
238,1,STEP,758508066864,758510699129,2632265,-1
239,1,STEP,758510774228,758513832588,3058360,-1
240,1,STEP,758513925786,758517149443,3223657,-1
241,1,STEP,758517224142,758520318601,3094459,-1
242,1,STEP,758520392400,758523336661,2944261,-1
243,1,STEP,758523410960,758526490619,3079659,-1
244,1,STEP,758526564918,758529817574,3252656,-1
245,1,STEP,758529914673,758533605124,3690451,-1
246,1,STEP,758533678323,758536025691,2347368,-1
247,1,STEP,758536097690,758538737555,2639865,-1
248,1,STEP,758538809754,758541780315,2970561,-1
249,1,STEP,758541853214,758544869073,3015859,-1
250,1,STEP,758544941872,758548579124,3637252,-1
251,1,STEP,758548654623,758551706782,3052159,-1
252,1,STEP,758551779181,758554950439,3171258,-1
253,1,STEP,758555023638,758557634503,2610865,-1
254,1,STEP,758557704202,758560738562,3034360,-1
255,1,STEP,758560809761,758563831720,3021959,-1
256,1,STEP,758563938619,758566977878,3039259,-1
257,1,STEP,758567050877,758570403033,3352156,-1
258,1,STEP,758570478032,758573050897,2572865,-1
259,1,STEP,758573121296,758576315654,3194358,-1
260,1,STEP,758576390053,758579959005,3568952,-1
261,1,STEP,758580032404,758583163562,3131158,-1
262,1,STEP,758583270861,758586438519,3167658,-1
263,1,STEP,758586553317,758590441465,3888148,-1
264,1,STEP,758590559364,758593569324,3009960,-1
265,1,STEP,758593681522,758596187089,2505567,-1
266,1,STEP,758596300787,758599469645,3168858,-1
267,1,STEP,758599584643,758603101396,3516753,-1
268,1,STEP,758603233695,758605655462,2421767,-1
269,1,STEP,758605764961,758608815320,3050359,-1
270,1,STEP,758608928719,758612334773,3406054,-1
271,1,STEP,758612451072,758615838226,3387154,-1
272,1,STEP,758615954425,758619148882,3194457,-1
273,1,STEP,758619264081,758621722348,2458267,-1
274,1,STEP,758621835746,758624461411,2625665,-1
275,1,STEP,758624574310,758627879466,3305156,-1
276,1,STEP,758627998764,758631189921,3191157,-1
277,1,STEP,758631304020,758634229581,2925561,-1
278,1,STEP,758634344479,758637329640,2985161,-1
279,1,STEP,758637442538,758640492097,3049559,-1
280,1,STEP,758640608096,758643743754,3135658,-1
281,1,STEP,758643859352,758646459018,2599666,-1
282,1,STEP,758646573516,758649408678,2835162,-1
283,1,STEP,758649521277,758652472537,2951260,-1
284,1,STEP,758652587536,758655699994,3112458,-1
285,1,STEP,758655815993,758658977351,3161358,-1
286,1,STEP,758659095349,758662288607,3193258,-1
287,1,STEP,758662403405,758665314566,2911161,-1
288,1,STEP,758665428365,758668545123,3116758,-1
289,1,STEP,758668658722,758671193688,2534966,-1
290,1,STEP,758671310186,758674133448,2823262,-1
291,1,STEP,758674248847,758676971911,2723064,-1
292,1,STEP,758677086209,758680322066,3235857,-1
293,1,STEP,758680437664,758683462424,3024760,-1
294,1,STEP,758683579322,758686682381,3103059,-1
295,1,STEP,758686796979,758690229734,3432755,-1
296,1,STEP,758690347432,758693044596,2697164,-1
297,1,STEP,758693157795,758696078656,2920861,-1
298,1,STEP,758696190754,758699280713,3089959,-1
299,1,STEP,758699395011,758702238673,2843662,-1
300,1,STEP,758702354372,758705369232,3014860,-1
301,1,STEP,758705481530,758707956497,2474967,-1
302,1,STEP,758708069896,758710939057,2869161,-1
303,1,STEP,758711053256,758714024216,2970960,-1
304,1,STEP,758714139515,758717156874,3017359,-1
305,1,STEP,758717269573,758720310432,3040859,-1
306,1,STEP,758720426031,758723716187,3290156,-1
307,1,STEP,758723829685,758726541249,2711564,-1
308,1,STEP,758726655848,758729583709,2927861,-1
309,1,STEP,758729695907,758732244973,2549066,-1
310,1,STEP,758732357571,758735729526,3371955,-1
311,1,STEP,758735842925,758739035382,3192457,-1
312,1,STEP,758739158581,758742215840,3057259,-1
313,1,STEP,758742329638,758745357898,3028260,-1
314,1,STEP,758745470897,758748290259,2819362,-1
315,1,STEP,758748402857,758751419317,3016460,-1
316,1,STEP,758751536416,758754353478,2817062,-1
317,1,STEP,758754463177,758757220740,2757563,-1
318,1,STEP,758757338838,758760451997,3113159,-1
319,1,STEP,758760565195,758763851351,3286156,-1
320,1,STEP,758763970650,758767063908,3093258,-1
321,1,STEP,758767178107,758770544862,3366755,-1
322,1,STEP,758770660960,758773677720,3016760,-1
323,1,STEP,758773790919,758777169174,3378255,-1
324,1,STEP,758777286772,758780021435,2734663,-1
325,1,STEP,758780133534,758783397890,3264356,-1
326,1,STEP,758783516289,758786906544,3390255,-1
327,1,STEP,758787022542,758789978803,2956261,-1
328,1,STEP,758790094601,758792675867,2581266,-1
329,1,STEP,758792787865,758796528115,3740250,-1
330,1,STEP,758796646514,758799750872,3104358,-1
331,1,STEP,758799865671,758802975829,3110158,-1
332,1,STEP,758803091728,758805508595,2416867,-1
333,1,STEP,758805619494,758808789952,3170458,-1
334,1,STEP,758808908350,758811975609,3067259,-1
335,1,STEP,758812091108,758814841271,2750163,-1
336,1,STEP,758814959069,758817950929,2991860,-1
337,1,STEP,758818064828,758821000689,2935861,-1
338,1,STEP,758821114387,758824170246,3055859,-1
339,1,STEP,758824286045,758827123407,2837362,-1
340,1,STEP,758827237405,758830477262,3239857,-1
341,1,STEP,758830590461,758833818118,3227657,-1
342,1,STEP,758833967016,758837162773,3195757,-1
343,1,STEP,758837278371,758840557628,3279257,-1
344,1,STEP,758840673726,758843838384,3164658,-1
345,1,STEP,758843952682,758846793544,2840862,-1
346,1,STEP,758846907343,758849874703,2967360,-1
347,1,STEP,758849990502,758853089060,3098558,-1
348,1,STEP,758853205259,758856573014,3367755,-1
349,1,STEP,758856688912,758859985068,3296156,-1
350,1,STEP,758860107467,758863106227,2998760,-1
351,1,STEP,758863220925,758866232685,3011760,-1
352,1,STEP,758866348583,758869664939,3316356,-1
353,1,STEP,758869780138,758872704399,2924261,-1
354,1,STEP,758872820397,758875750958,2930561,-1
355,1,STEP,758875865956,758879450309,3584353,-1
356,1,STEP,758879568107,758882590367,3022260,-1
357,1,STEP,758882703565,758885710825,3007260,-1
358,1,STEP,758885826024,758888701785,2875761,-1
359,1,STEP,758888777784,758891769344,2991560,-1
360,1,STEP,758891842143,758895208298,3366155,-1
361,1,STEP,758895284097,758898172559,2888462,-1
362,1,STEP,758898246358,758900810424,2564066,-1
363,1,STEP,758900882123,758903437489,2555366,-1
364,1,STEP,758903511588,758906408949,2897361,-1
365,1,STEP,758906482448,758909549607,3067159,-1
366,1,STEP,758909622806,758912874063,3251257,-1
367,1,STEP,758912948362,758915842323,2893961,-1
368,1,STEP,758915916522,758918693385,2776863,-1
369,1,STEP,758918768684,758921633446,2864762,-1
370,1,STEP,758921705045,758924069713,2364668,-1
371,1,STEP,758924142512,758927250571,3108059,-1
372,1,STEP,758927323670,758930472528,3148858,-1
373,1,STEP,758930546827,758933378889,2832062,-1
374,1,STEP,758933448588,758936278750,2830162,-1
375,1,STEP,758936352049,758939159712,2807663,-1
376,1,STEP,758939233711,758941860776,2627065,-1
377,1,STEP,758941950275,758945060033,3109758,-1
378,1,STEP,758945133932,758948068993,2935061,-1
379,1,STEP,758948146592,758951074553,2927961,-1
380,1,STEP,758951149152,758954187511,3038359,-1
381,1,STEP,758954262010,758956762377,2500367,-1
382,1,STEP,758956834876,758960036333,3201457,-1
383,1,STEP,758960111932,758962963894,2851962,-1
384,1,STEP,758963036993,758966091853,3054860,-1
385,1,STEP,758966167251,758969140512,2973261,-1
386,1,STEP,758969215611,758972384369,3168758,-1
387,1,STEP,758972459768,758975441028,2981260,-1
388,1,STEP,758975516427,758978606985,3090558,-1
389,1,STEP,758978682684,758981321349,2638665,-1
390,1,STEP,758981394748,758984402208,3007460,-1
391,1,STEP,758984475707,758987435568,2959861,-1
392,1,STEP,758987509567,758990669225,3159658,-1
393,1,STEP,758990744024,758993773983,3029959,-1
394,1,STEP,758993847182,758996863042,3015860,-1
395,1,STEP,758996935641,759000302996,3367355,-1
396,1,STEP,759000377795,759003372855,2995060,-1
397,1,STEP,759003445554,759006244317,2798763,-1
398,1,STEP,759006316616,759009279676,2963060,-1
399,1,STEP,759009352475,759012828429,3475954,-1
400,1,STEP,759012901928,759015847289,2945361,-1
401,1,STEP,759015920188,759018651151,2730963,-1
402,1,STEP,759018724650,759021050419,2325769,-1
403,1,STEP,759021121618,759024166078,3044460,-1
404,1,STEP,759024240177,759026772943,2532766,-1
405,1,STEP,759026844242,759029667904,2823662,-1
406,1,STEP,759029739503,759032452967,2713464,-1
407,1,STEP,759032524766,759035669324,3144558,-1
408,1,STEP,759035743723,759038944480,3200757,-1
409,1,STEP,759039019479,759042304236,3284757,-1
410,1,STEP,759042377035,759045180097,2803062,-1
411,1,STEP,759045251896,759048425054,3173158,-1
412,1,STEP,759048498353,759051152117,2653764,-1
413,1,STEP,759051226016,759054697470,3471454,-1
414,1,STEP,759054772869,759057601531,2828662,-1
415,1,STEP,759057674130,759060019799,2345669,-1
416,1,STEP,759060093098,759063147057,3053959,-1
417,1,STEP,759063221756,759065815022,2593266,-1
418,1,STEP,759065916720,759068954280,3037560,-1
419,1,STEP,759069031379,759072019939,2988560,-1
420,1,STEP,759072092838,759074805702,2712864,-1
421,1,STEP,759074879201,759077642264,2763063,-1
422,1,STEP,759077715463,759080996219,3280756,-1
423,1,STEP,759081069718,759084131977,3062259,-1
424,1,STEP,759084204776,759086917840,2713064,-1
425,1,STEP,759086991039,759089949700,2958661,-1
426,1,STEP,759090024299,759093249356,3225057,-1
427,1,STEP,759093330955,759095842921,2511966,-1
428,1,STEP,759095914920,759099400374,3485454,-1
429,1,STEP,759099474873,759102520832,3045959,-1
430,1,STEP,759102593531,759105337694,2744163,-1
431,1,STEP,759105409493,759108432653,3023160,-1
432,1,STEP,759108504652,759111185316,2680664,-1
433,1,STEP,759111258615,759114709169,3450554,-1
434,1,STEP,759114783168,759117413033,2629865,-1
435,1,STEP,759117485232,759120751889,3266657,-1
436,1,STEP,759120825888,759123614250,2788362,-1
437,1,STEP,759123688150,759126763108,3074958,-1
438,1,STEP,759126836607,759130265762,3429155,-1
439,1,STEP,759130340461,759133540318,3199857,-1
440,1,STEP,759133614917,759136523678,2908761,-1
441,1,STEP,759136594577,759139250642,2656065,-1
442,1,STEP,759139325641,759142515798,3190157,-1
443,1,STEP,759142586697,759146279948,3693251,-1
444,1,STEP,759146355547,759149558804,3203257,-1
445,1,STEP,759149629903,759152191769,2561866,-1
446,1,STEP,759152264268,759155612824,3348556,-1
447,1,STEP,759155689322,759158447486,2758164,-1
448,1,STEP,759158522285,759161320647,2798362,-1
449,1,STEP,759161395446,759164189709,2794263,-1
450,1,STEP,759164263108,759167096870,2833762,-1
451,1,STEP,759167172769,759170174129,3001360,-1
452,1,STEP,759170250928,759173337987,3087059,-1
453,1,STEP,759173413586,759176426246,3012660,-1
454,1,STEP,759176500845,759179531104,3030259,-1
455,1,STEP,759179605703,759183029758,3424055,-1
456,1,STEP,759183188156,759186204015,3015859,-1
457,1,STEP,759186279314,759189233775,2954461,-1
458,1,STEP,759189307874,759192304634,2996760,-1
459,1,STEP,759192379433,759195651289,3271856,-1
460,1,STEP,759195727288,759198811347,3084059,-1
461,1,STEP,759198887746,759201985205,3097459,-1
462,1,STEP,759202059704,759205618156,3558452,-1
463,1,STEP,759205691355,759208952812,3261457,-1
464,1,STEP,759209032311,759212622163,3589852,-1
465,1,STEP,759212732161,759216625909,3893748,-1
466,1,STEP,759216742308,759220332160,3589852,-1
467,1,STEP,759220449458,759224658302,4208844,-1
468,1,STEP,759224797200,759228366953,3569753,-1
469,1,STEP,759228443952,759231950805,3506853,-1
470,1,STEP,759232027904,759235594756,3566852,-1
471,1,STEP,759235669655,759238617016,2947361,-1
472,1,STEP,759238691615,759242306867,3615252,-1
473,1,STEP,759242383566,759245678622,3295056,-1
474,1,STEP,759245753721,759250094663,4340942,-1
475,1,STEP,759250172762,759253077423,2904661,-1
476,1,STEP,759253152722,759256178782,3026060,-1
477,1,STEP,759256253981,759259453338,3199357,-1
478,1,STEP,759259529437,759263065990,3536553,-1
479,1,STEP,759263143189,759266162348,3019159,-1
480,1,STEP,759266236847,759269176808,2939961,-1
481,1,STEP,759269248207,759272372665,3124458,-1
482,1,STEP,759272447764,759274908632,2460868,-1
483,1,STEP,759274982631,759277860792,2878161,-1
484,1,STEP,759277949891,759280792253,2842362,-1
485,1,STEP,759280865152,759284262207,3397055,-1
486,1,STEP,759284333206,759287068269,2735063,-1
487,1,STEP,759287142168,759289977831,2835663,-1
488,1,STEP,759290051830,759293439684,3387854,-1
489,1,STEP,759293515283,759296715141,3199858,-1
490,1,STEP,759296788340,759299682401,2894061,-1
491,1,STEP,759299759100,759302490764,2731664,-1
492,1,STEP,759302563763,759305953217,3389454,-1
493,1,STEP,759306029316,759308599182,2569866,-1
494,1,STEP,759308670781,759311421844,2751063,-1
495,1,STEP,759311495643,759314199007,2703364,-1
496,1,STEP,759314270406,759317112268,2841862,-1
497,1,STEP,759317184267,759320171128,2986861,-1
498,1,STEP,759320244327,759324051376,3807049,-1
499,1,STEP,759324126575,759327251633,3125058,-1
500,1,STEP,759327323432,759330570789,3247357,-1
501,1,STEP,759330643688,759333412851,2769163,-1
502,1,STEP,759333483350,759336592008,3108658,-1
503,1,STEP,759336668507,759339990363,3321856,-1
504,1,STEP,759340067162,759343017823,2950661,-1
505,1,STEP,759343092522,759346023383,2930861,-1
506,1,STEP,759346131781,759348934844,2803063,-1
507,1,STEP,759349047342,759352132001,3084659,-1
508,1,STEP,759352246900,759355282059,3035159,-1
509,1,STEP,759355394958,759358308119,2913161,-1
510,1,STEP,759358423017,759361294779,2871762,-1
511,1,STEP,759361405177,759364459237,3054060,-1
512,1,STEP,759364615635,759367673294,3057659,-1
513,1,STEP,759367787392,759370514456,2727064,-1
514,1,STEP,759370624854,759373619514,2994660,-1
515,1,STEP,759373724213,759376515876,2791663,-1
516,1,STEP,759376626574,759379848031,3221457,-1
517,1,STEP,759379957330,759382959590,3002260,-1
518,1,STEP,759383073188,759386445643,3372455,-1
519,1,STEP,759386557542,759389675400,3117858,-1
520,1,STEP,759389784299,759393165254,3380955,-1
521,1,STEP,759393278252,759396587008,3308756,-1
522,1,STEP,759396698406,759399949163,3250757,-1
523,1,STEP,759400064262,759403372917,3308655,-1
524,1,STEP,759403486116,759406711673,3225557,-1
525,1,STEP,759406825471,759410334024,3508553,-1
526,1,STEP,759410444423,759413482782,3038359,-1
527,1,STEP,759413593281,759416443443,2850162,-1
528,1,STEP,759416555041,759419371204,2816163,-1
529,1,STEP,759419484002,759422831958,3347956,-1
530,1,STEP,759422946956,759426109214,3162258,-1
531,1,STEP,759426221412,759429601167,3379755,-1
532,1,STEP,759429712166,759432467929,2755763,-1
533,1,STEP,759432578828,759435865684,3286856,-1
534,1,STEP,759435982382,759438754645,2772263,-1
535,1,STEP,759438866144,759441999502,3133358,-1
536,1,STEP,759442114600,759445152260,3037660,-1
537,1,STEP,759445264558,759447985322,2720764,-1
538,1,STEP,759448096521,759451923069,3826548,-1
539,1,STEP,759452039268,759454605434,2566166,-1
540,1,STEP,759454720032,759457593094,2873062,-1
541,1,STEP,759457706392,759461125247,3418855,-1
542,1,STEP,759461241745,759463508715,2266970,-1
543,1,STEP,759463620413,759466695972,3075559,-1
544,1,STEP,759466818371,759469853730,3035359,-1
545,1,STEP,759469979229,759473444482,3465253,-1
546,1,STEP,759473561981,759476360143,2798162,-1
547,1,STEP,759476474442,759479945996,3471554,-1
548,1,STEP,759480064194,759483537748,3473554,-1
549,1,STEP,759483653946,759486793704,3139758,-1
550,1,STEP,759486909403,759490108160,3198757,-1
551,1,STEP,759490223958,759493253118,3029160,-1
552,1,STEP,759493367616,759496248378,2880762,-1
553,1,STEP,759496361776,759499566834,3205058,-1
554,1,STEP,759499693832,759503140486,3446654,-1
555,1,STEP,759503259484,759506520841,3261357,-1
556,1,STEP,759506638339,759509482201,2843862,-1
557,1,STEP,759509597900,759512406262,2808362,-1
558,1,STEP,759512522761,759515942515,3419754,-1
559,1,STEP,759516060514,759520017361,3956847,-1
560,1,STEP,759520153559,759523555514,3401955,-1
561,1,STEP,759523634713,759526176579,2541866,-1
562,1,STEP,759526250278,759528835243,2584965,-1
563,1,STEP,759528906242,759532080500,3174258,-1
564,1,STEP,759532152299,759535579953,3427654,-1
565,1,STEP,759535654752,759538642012,2987260,-1
566,1,STEP,759538715811,759541654672,2938861,-1
567,1,STEP,759541726471,759544863629,3137158,-1
568,1,STEP,759544936128,759547683892,2747764,-1
569,1,STEP,759547753991,759550766851,3012860,-1
570,1,STEP,759550836550,759554128306,3291756,-1
571,1,STEP,759554201305,759557775457,3574152,-1
572,1,STEP,759557853256,759561239611,3386355,-1
573,1,STEP,759561315910,759564913362,3597452,-1
574,1,STEP,759564994161,759568777510,3783349,-1
575,1,STEP,759568860709,759571970368,3109659,-1
576,1,STEP,759572045967,759574843029,2797062,-1
577,1,STEP,759574914728,759577902488,2987760,-1
578,1,STEP,759577977787,759581006647,3028860,-1
579,1,STEP,759581077346,759584482401,3405055,-1
580,1,STEP,759584623399,759589472134,4848735,-1
581,1,STEP,759589612732,759593355482,3742750,-1
582,1,STEP,759593484980,759596839536,3354556,-1
583,1,STEP,759596916335,759599589499,2673164,-1
584,1,STEP,759599663798,759602587659,2923861,-1
585,1,STEP,759602663058,759605728817,3065759,-1
586,1,STEP,759605802816,759609089272,3286456,-1
587,1,STEP,759609166971,759612356429,3189458,-1
588,1,STEP,759612432228,759615850882,3418654,-1
589,1,STEP,759615926181,759618872142,2945961,-1
590,1,STEP,759618947041,759622158398,3211357,-1
591,1,STEP,759622232697,759625400455,3167758,-1
592,1,STEP,759625475254,759629105205,3629951,-1
593,1,STEP,759629181304,759632132065,2950761,-1
594,1,STEP,759632207764,759634797829,2590065,-1
595,1,STEP,759634872428,759637704590,2832162,-1
596,1,STEP,759637777889,759640414054,2636165,-1
597,1,STEP,759640488553,759643319215,2830662,-1
598,1,STEP,759643401014,759646153778,2752764,-1
599,1,STEP,759646226477,759649567032,3340555,-1
600,1,STEP,759649641331,759652804689,3163358,-1
601,1,STEP,759652878788,759656431840,3553052,-1
602,1,STEP,759656511139,759659491600,2980461,-1
603,1,STEP,759659566999,759662660957,3093958,-1
604,1,STEP,759662736556,759665513219,2776663,-1
605,1,STEP,759665585518,759669138971,3553453,-1
606,1,STEP,759669216270,759672174230,2957960,-1
607,1,STEP,759672250029,759675313989,3063960,-1
608,1,STEP,759675388388,759678451547,3063159,-1
609,1,STEP,759678526246,759681529106,3002860,-1
610,1,STEP,759681602205,759684689663,3087458,-1
611,1,STEP,759684763862,759687379428,2615566,-1
612,1,STEP,759687453327,759690293689,2840362,-1
613,1,STEP,759690366888,759693019952,2653064,-1
614,1,STEP,759693093251,759696452806,3359555,-1
615,1,STEP,759696526305,759699458066,2931761,-1
616,1,STEP,759699530765,759702297128,2766363,-1
617,1,STEP,759702369727,759704870194,2500467,-1
618,1,STEP,759704941193,759707988753,3047560,-1
619,1,STEP,759708063252,759711185710,3122458,-1
620,1,STEP,759711259509,759714308968,3049459,-1
621,1,STEP,759714383567,759717121331,2737764,-1
622,1,STEP,759717193730,759719996892,2803162,-1
623,1,STEP,759720070691,759723142950,3072259,-1
624,1,STEP,759723218149,759726495106,3276957,-1
625,1,STEP,759726570305,759729791162,3220857,-1
626,1,STEP,759729861861,759732777722,2915861,-1
627,1,STEP,759732849721,759736070478,3220757,-1
628,1,STEP,759736146777,759739373234,3226457,-1
629,1,STEP,759739447633,759742593791,3146158,-1
630,1,STEP,759742670490,759746228342,3557852,-1
631,1,STEP,759746303341,759749147303,2843962,-1
632,1,STEP,759749220802,759752217662,2996860,-1
633,1,STEP,759752290661,759755301021,3010360,-1
634,1,STEP,759755374620,759758345481,2970861,-1
635,1,STEP,759758417380,759761265442,2848062,-1
636,1,STEP,759761337141,759763946206,2609065,-1
637,1,STEP,759764021905,759767499258,3477353,-1
638,1,STEP,759767573457,759770856114,3282657,-1
639,1,STEP,759770932213,759773627477,2695264,-1
640,1,STEP,759773699676,759776611837,2912161,-1
641,1,STEP,759776686936,759779758095,3071159,-1
642,1,STEP,759779832594,759782753455,2920861,-1
643,1,STEP,759782828154,759785699116,2870962,-1
644,1,STEP,759785772415,759788982872,3210457,-1
645,1,STEP,759789057371,759792105230,3047859,-1
646,1,STEP,759792178629,759795204889,3026260,-1
647,1,STEP,759795278088,759798679742,3401654,-1
648,1,STEP,759798755441,759801757601,3002160,-1
649,1,STEP,759801829300,759805479752,3650452,-1
650,1,STEP,759805556251,759809370000,3813749,-1
651,1,STEP,759809488598,759812221462,2732864,-1
652,1,STEP,759812296961,759815467218,3170257,-1
653,1,STEP,759815543517,759818157282,2613765,-1
654,1,STEP,759818229981,759821327940,3097959,-1
655,1,STEP,759821399539,759824603196,3203657,-1
656,1,STEP,759824676195,759827746454,3070259,-1
657,1,STEP,759827818353,759830815213,2996860,-1
658,1,STEP,759830884313,759833489678,2605365,-1
659,1,STEP,759833557477,759836862633,3305156,-1
660,1,STEP,759836935532,759840265987,3330455,-1
661,1,STEP,759840339586,759843638042,3298456,-1
662,1,STEP,759843712441,759846719001,3006560,-1
663,1,STEP,759846790600,759850019557,3228957,-1
664,1,STEP,759850094156,759853100416,3006260,-1
665,1,STEP,759853169715,759856591670,3421955,-1
666,1,STEP,759856665769,759859664129,2998360,-1
667,1,STEP,759859738428,759862741487,3003059,-1
668,1,STEP,759862814186,759865541350,2727164,-1
669,1,STEP,759865612349,759868250214,2637865,-1
670,1,STEP,759868323413,759872076963,3753550,-1
671,1,STEP,759872153762,759875466618,3312856,-1
672,1,STEP,759875541317,759878756174,3214857,-1
673,1,STEP,759878828373,759881607036,2778663,-1
674,1,STEP,759881679035,759884531397,2852362,-1
675,1,STEP,759884604296,759887803953,3199657,-1
676,1,STEP,759887876952,759890628115,2751163,-1
677,1,STEP,759890701314,759893791773,3090459,-1
678,1,STEP,759893864372,759896323439,2459067,-1
679,1,STEP,759896395438,759899555796,3160358,-1
680,1,STEP,759899632195,759903093149,3460954,-1
681,1,STEP,759903169048,759906404405,3235357,-1
682,1,STEP,759906479804,759909946458,3466654,-1
683,1,STEP,759910026056,759913262313,3236257,-1
684,1,STEP,759913336612,759916381672,3045060,-1
685,1,STEP,759916455471,759919963524,3508053,-1
686,1,STEP,759920039423,759923011183,2971760,-1
687,1,STEP,759923088282,759926626435,3538153,-1
688,1,STEP,759926702834,759929694294,2991460,-1
689,1,STEP,759929768193,759934287033,4518840,-1
690,1,STEP,759934362932,759937395691,3032759,-1
691,1,STEP,759937470790,759940693547,3222757,-1
692,1,STEP,759940770146,759944766393,3996247,-1
693,1,STEP,759944842992,759947561256,2718264,-1
694,1,STEP,759947636055,759950569315,2933260,-1
695,1,STEP,759950647414,759953377478,2730064,-1
696,1,STEP,759953450677,759955997943,2547266,-1
697,1,STEP,759956070142,759958806106,2735964,-1
698,1,STEP,759958878905,759961943764,3064859,-1
699,1,STEP,759962018763,759965174621,3155858,-1
700,1,STEP,759965247220,759968434677,3187457,-1
701,1,STEP,759968509376,759971505436,2996060,-1
702,1,STEP,759971578435,759974830792,3252357,-1
703,1,STEP,759974904091,759977517456,2613365,-1
704,1,STEP,759977590855,759980567515,2976660,-1
705,1,STEP,759980638814,759983190580,2551766,-1
706,1,STEP,759983262879,759985737746,2474867,-1
707,1,STEP,759985805245,759988706007,2900762,-1
708,1,STEP,759988777906,759991776866,2998960,-1
709,1,STEP,759991849465,759994907724,3058259,-1
710,1,STEP,759994979823,759998148681,3168858,-1
711,1,STEP,759998221780,760000997043,2775263,-1
712,1,STEP,760001072242,760004197400,3125158,-1
713,1,STEP,760004273699,760008172847,3899148,-1
714,1,STEP,760008250546,760011356404,3105858,-1
715,1,STEP,760011431003,760014760559,3329556,-1
716,1,STEP,760014838758,760017997616,3158858,-1
717,1,STEP,760018072115,760020890677,2818562,-1
718,1,STEP,760020966276,760023726939,2760663,-1
719,1,STEP,760023804338,760026951196,3146858,-1
720,1,STEP,760027028595,760030452249,3423654,-1
721,1,STEP,760030527848,760033370311,2842463,-1
722,1,STEP,760033442010,760036964463,3522453,-1
723,1,STEP,760037038062,760039974222,2936160,-1
724,1,STEP,760040048321,760043441276,3392955,-1
725,1,STEP,760043515575,760046779332,3263757,-1
726,1,STEP,760046854231,760049855691,3001460,-1
727,1,STEP,760049951189,760053054448,3103259,-1
728,1,STEP,760053129047,760056130407,3001360,-1
729,1,STEP,760056204406,760059610460,3406054,-1
730,1,STEP,760059684959,760063329311,3644352,-1
731,1,STEP,760063405510,760066493169,3087659,-1
732,1,STEP,760066565468,760069328431,2762963,-1
733,1,STEP,760069400130,760072225092,2824962,-1
734,1,STEP,760072297191,760074844257,2547066,-1
735,1,STEP,760074917656,760077551621,2633965,-1
736,1,STEP,760077623620,760080597180,2973560,-1
737,1,STEP,760080669579,760083344944,2675365,-1
738,1,STEP,760083417843,760086227605,2809762,-1
739,1,STEP,760086301504,760089356563,3055059,-1
740,1,STEP,760089431262,760092154226,2722964,-1
741,1,STEP,760092225925,760094963989,2738064,-1
742,1,STEP,760095037488,760098127246,3089758,-1
743,1,STEP,760098201045,760101786198,3585153,-1
744,1,STEP,760101858597,760104891256,3032659,-1
745,1,STEP,760104966055,760108301411,3335356,-1
746,1,STEP,760108376510,760111450469,3073959,-1
747,1,STEP,760111525268,760114087433,2562165,-1
748,1,STEP,760114160732,760117293191,3132459,-1
749,1,STEP,760117366990,760119784257,2417267,-1
750,1,STEP,760119856256,760122994415,3138159,-1
751,1,STEP,760123068114,760126221772,3153658,-1
752,1,STEP,760126294171,760129222831,2928660,-1
753,1,STEP,760129293031,760131811897,2518866,-1
754,1,STEP,760131880096,760135132953,3252857,-1
755,1,STEP,760135206552,760137785917,2579365,-1
756,1,STEP,760137856716,760140854276,2997560,-1
757,1,STEP,760140926575,760143679939,2753364,-1
758,1,STEP,760143753138,760146975295,3222157,-1
759,1,STEP,760147048594,760150250351,3201757,-1
760,1,STEP,760150321650,760152890016,2568366,-1
761,1,STEP,760152962415,760156225071,3262656,-1
762,1,STEP,760156298370,760159227431,2929061,-1
763,1,STEP,760159301730,760162096893,2795163,-1
764,1,STEP,760162170992,760164880856,2709864,-1
765,1,STEP,760164952255,760167790117,2837862,-1
766,1,STEP,760167864016,760170926475,3062459,-1
767,1,STEP,760171001674,760174339729,3338055,-1
768,1,STEP,760174425128,760177185991,2760863,-1
769,1,STEP,760177257890,760179577660,2319770,-1
770,1,STEP,760179648759,760182896015,3247256,-1
771,1,STEP,760182969414,760185961774,2992360,-1
772,1,STEP,760186036873,760188884435,2847562,-1
773,1,STEP,760188957434,760192439088,3481654,-1
774,1,STEP,760192514187,760195355949,2841762,-1
775,1,STEP,760195428248,760198430308,3002060,-1
776,1,STEP,760198499107,760201767663,3268556,-1
777,1,STEP,760201840162,760204674325,2834163,-1
778,1,STEP,760204746724,760207741784,2995060,-1
779,1,STEP,760207815683,760210984040,3168357,-1
780,1,STEP,760211059439,760213671605,2612166,-1
781,1,STEP,760213745604,760216087972,2342368,-1
782,1,STEP,760216160171,760219234330,3074159,-1
783,1,STEP,760219309129,760222159791,2850662,-1
784,1,STEP,760222230190,760224913655,2683465,-1
785,1,STEP,760224986854,760228031713,3044859,-1
786,1,STEP,760228106012,760231100172,2994160,-1
787,1,STEP,760231169071,760233720337,2551266,-1
788,1,STEP,760233791236,760237006193,3214957,-1
789,1,STEP,760237081192,760240170051,3088859,-1
790,1,STEP,760240245150,760243593605,3348455,-1
791,1,STEP,760243669704,760246738263,3068559,-1
792,1,STEP,760246811562,760250011920,3200358,-1
793,1,STEP,760250087019,760253181377,3094358,-1
794,1,STEP,760253251576,760256608932,3357356,-1
795,1,STEP,760256683631,760259811389,3127758,-1
796,1,STEP,760259888788,760263272843,3384055,-1
797,1,STEP,760263349242,760265970807,2621565,-1
798,1,STEP,760266046006,760269297062,3251056,-1
799,1,STEP,760269371361,760272265423,2894062,-1
800,1,STEP,760272339522,760275161684,2822162,-1
801,1,STEP,760275234683,760278596638,3361955,-1
802,1,STEP,760278673137,760281164804,2491667,-1
803,1,STEP,760281233503,760284861855,3628352,-1
804,1,STEP,760284938154,760288462707,3524553,-1
805,1,STEP,760288538306,760291209170,2670864,-1
806,1,STEP,760291284169,760294449527,3165358,-1
807,1,STEP,760294523626,760297577785,3054159,-1
808,1,STEP,760297652784,760300365848,2713064,-1
809,1,STEP,760300439447,760303328608,2889161,-1
810,1,STEP,760303403107,760305968073,2564966,-1
811,1,STEP,760306042972,760309122531,3079559,-1
812,1,STEP,760309197030,760312454886,3257856,-1
813,1,STEP,760312529785,760315504646,2974861,-1
814,1,STEP,760315580845,760318440207,2859362,-1
815,1,STEP,760318514406,760322227356,3712950,-1
816,1,STEP,760322303355,760325968306,3664951,-1
817,1,STEP,760326045105,760329302262,3257157,-1
818,1,STEP,760329378161,760332466019,3087858,-1
819,1,STEP,760332538318,760335604677,3066359,-1
820,1,STEP,760335684176,760338446640,2762464,-1
821,1,STEP,760338522239,760341521999,2999760,-1
822,1,STEP,760341597498,760344372060,2774562,-1
823,1,STEP,760344446160,760347696216,3250056,-1
824,1,STEP,760347801915,760350351981,2550066,-1
825,1,STEP,760350426480,760353159243,2732763,-1
826,1,STEP,760353232542,760356431600,3199058,-1
827,1,STEP,760356506999,760358997965,2490966,-1
828,1,STEP,760359072964,760361836427,2763463,-1
829,1,STEP,760361933826,760364821288,2887462,-1
830,1,STEP,760364893087,760367592851,2699764,-1
831,1,STEP,760367666350,760370540111,2873761,-1
832,1,STEP,760370613310,760373648970,3035660,-1
833,1,STEP,760373719469,760376362834,2643365,-1
834,1,STEP,760376435633,760379670689,3235056,-1
835,1,STEP,760379744288,760382635650,2891362,-1
836,1,STEP,760382708849,760386152503,3443654,-1
837,1,STEP,760386226602,760389175263,2948661,-1
838,1,STEP,760389245762,760391972725,2726963,-1
839,1,STEP,760392046524,760394700489,2653965,-1
840,1,STEP,760394775288,760397650750,2875462,-1
841,1,STEP,760397722349,760400630610,2908261,-1
842,1,STEP,760400703809,760403491872,2788063,-1
843,1,STEP,760403564671,760406827327,3262656,-1
844,1,STEP,760406899226,760410094783,3195557,-1
845,1,STEP,760410169482,760413379340,3209858,-1
846,1,STEP,760413449339,760416802294,3352955,-1
847,1,STEP,760416877893,760420149749,3271856,-1
848,1,STEP,760420223648,760423434805,3211157,-1
849,1,STEP,760423509404,760426995658,3486254,-1
850,1,STEP,760427070157,760429770021,2699864,-1
851,1,STEP,760429840020,760433062777,3222757,-1
852,1,STEP,760433136676,760436688829,3552153,-1
853,1,STEP,760436763428,760439969485,3206057,-1
854,1,STEP,760440053484,760442812347,2758863,-1
855,1,STEP,760442886546,760445696308,2809762,-1
856,1,STEP,760445766907,760448599070,2832163,-1
857,1,STEP,760448670769,760451708128,3037359,-1
858,1,STEP,760451782227,760455172082,3389855,-1
859,1,STEP,760455246181,760458548237,3302056,-1
860,1,STEP,760458622536,760461799194,3176658,-1
861,1,STEP,760461883192,760465011451,3128259,-1
862,1,STEP,760465080450,760468505804,3425354,-1
863,1,STEP,760468579903,760471944658,3364755,-1
864,1,STEP,760472019757,760475219014,3199257,-1
865,1,STEP,760475294213,760478467671,3173458,-1
866,1,STEP,760478541070,760481328133,2787063,-1
867,1,STEP,760481400332,760484463691,3063359,-1
868,1,STEP,760484539890,760487563450,3023560,-1
869,1,STEP,760487641049,760491071103,3430054,-1
870,1,STEP,760491146302,760494217361,3071059,-1
871,1,STEP,760494291360,760497018024,2726664,-1
872,1,STEP,760497089023,760500268580,3179557,-1
873,1,STEP,760500343079,760503357839,3014760,-1
874,1,STEP,760503427138,760506212001,2784863,-1
875,1,STEP,760506285300,760509317859,3032559,-1
876,1,STEP,760509390658,760512334619,2943961,-1
877,1,STEP,760512407418,760515269380,2861962,-1
878,1,STEP,760515343979,760518725934,3381955,-1
879,1,STEP,760518802533,760521716294,2913761,-1
880,1,STEP,760521788393,760525248047,3459654,-1
881,1,STEP,760525324046,760528112409,2788363,-1
882,1,STEP,760528186908,760530749373,2562465,-1
883,1,STEP,760530821972,760533663035,2841063,-1
884,1,STEP,760533736834,760536322699,2585865,-1
885,1,STEP,760536394498,760539865052,3470554,-1
886,1,STEP,760539940251,760542845612,2905361,-1
887,1,STEP,760542918511,760545979670,3061159,-1
888,1,STEP,760546054069,760548721234,2667165,-1
889,1,STEP,760548793133,760552093789,3300656,-1
890,1,STEP,760552169288,760555157948,2988660,-1
891,1,STEP,760555230447,760558585902,3355455,-1
892,1,STEP,760558659601,760561636861,2977260,-1
893,1,STEP,760561707860,760564071629,2363769,-1
894,1,STEP,760564142728,760567096988,2954260,-1
895,1,STEP,760567170387,760569803252,2632865,-1
896,1,STEP,760569890751,760573005910,3115159,-1
897,1,STEP,760573078209,760576233266,3155057,-1
898,1,STEP,760576307766,760579014929,2707163,-1
899,1,STEP,760579087628,760582575982,3488354,-1
900,1,STEP,760582650281,760585239546,2589265,-1
901,1,STEP,760585310645,760588424304,3113659,-1
902,1,STEP,760588496503,760591345265,2848762,-1
903,1,STEP,760591417264,760594489223,3071959,-1
904,1,STEP,760594562722,760597785379,3222657,-1
905,1,STEP,760597859578,760600672540,2812962,-1
906,1,STEP,760600744439,760603653501,2909062,-1
907,1,STEP,760603725700,760606904857,3179157,-1
908,1,STEP,760606979256,760609714720,2735464,-1
909,1,STEP,760609785519,760612410784,2625265,-1
910,1,STEP,760612481483,760615153547,2672064,-1
911,1,STEP,760615225146,760618658500,3433354,-1
912,1,STEP,760618732899,760621152267,2419368,-1
913,1,STEP,760621222466,760624276625,3054159,-1
914,1,STEP,760624348824,760627534182,3185358,-1
915,1,STEP,760627608381,760630690840,3082459,-1
916,1,STEP,760630764339,760633313605,2549266,-1
917,1,STEP,760633383704,760635837071,2453367,-1
918,1,STEP,760635908370,760638847931,2939561,-1
919,1,STEP,760638920930,760642124487,3203557,-1
920,1,STEP,760642199786,760645384444,3184658,-1
921,1,STEP,760645452843,760648801098,3348255,-1
922,1,STEP,760648874797,760651566361,2691564,-1
923,1,STEP,760651638360,760654920216,3281856,-1
924,1,STEP,760654996915,760657566881,2569966,-1
925,1,STEP,760657642880,760660915936,3273056,-1
926,1,STEP,760660991735,760664054595,3062860,-1
927,1,STEP,760664125194,760666681760,2556566,-1
928,1,STEP,760666758059,760669411723,2653664,-1
929,1,STEP,760669483822,760672556381,3072559,-1
930,1,STEP,760672631280,760675449543,2818263,-1
931,1,STEP,760675520842,760678187006,2666164,-1
932,1,STEP,760678259805,760681682559,3422754,-1
933,1,STEP,760681756658,760684902016,3145358,-1
934,1,STEP,760684975315,760688180573,3205258,-1
935,1,STEP,760688254872,760691758625,3503753,-1
936,1,STEP,760691833024,760695189579,3356555,-1
937,1,STEP,760695264178,760698076241,2812063,-1
938,1,STEP,760698148840,760701440696,3291856,-1
939,1,STEP,760701523795,760704122960,2599165,-1
940,1,STEP,760704195159,760707236918,3041759,-1
941,1,STEP,760707310917,760710132880,2821963,-1
942,1,STEP,760710204079,760712959442,2755363,-1
943,1,STEP,760713032441,760715858803,2826362,-1
944,1,STEP,760715930302,760718969362,3039060,-1
945,1,STEP,760719043861,760722292117,3248256,-1
946,1,STEP,760722367816,760725812070,3444254,-1
947,1,STEP,760725912569,760728943529,3030960,-1
948,1,STEP,760729017828,760731318197,2300369,-1
949,1,STEP,760731389596,760735021048,3631452,-1
950,1,STEP,760735097547,760738446702,3349155,-1
951,1,STEP,760738522401,760741479061,2956660,-1
952,1,STEP,760741550460,760744935515,3385055,-1
953,1,STEP,760745010914,760747382883,2371969,-1
954,1,STEP,760747454782,760750661939,3207157,-1
955,1,STEP,760750736438,760753530201,2793763,-1
956,1,STEP,760753601700,760757188252,3586552,-1
957,1,STEP,760757263351,760760371209,3107858,-1
958,1,STEP,760760444908,760763453968,3009060,-1
959,1,STEP,760763529267,760766401929,2872662,-1
960,1,STEP,760766475228,760769563287,3088059,-1
961,1,STEP,760769636886,760773036340,3399454,-1
962,1,STEP,760773113239,760776352196,3238957,-1
963,1,STEP,760776426795,760779314757,2887962,-1
964,1,STEP,760779387956,760782466614,3078658,-1
965,1,STEP,760782541413,760786010767,3469354,-1
966,1,STEP,760786086566,760789127926,3041360,-1
967,1,STEP,760789201625,760792023287,2821662,-1
968,1,STEP,760792097086,760795131845,3034759,-1
969,1,STEP,760795205944,760797728811,2522867,-1
970,1,STEP,760797802410,760800454774,2652364,-1
971,1,STEP,760800527273,760803419635,2892362,-1
972,1,STEP,760803495134,760806490094,2994960,-1
973,1,STEP,760806563693,760809405555,2841862,-1
974,1,STEP,760809477354,760812453414,2976060,-1
975,1,STEP,760812525813,760815530173,3004360,-1
976,1,STEP,760815605672,760818723731,3118059,-1
977,1,STEP,760818799330,760821429595,2630265,-1
978,1,STEP,760821502394,760824597052,3094658,-1
979,1,STEP,760824672151,760827794110,3121959,-1
980,1,STEP,760827868609,760830969967,3101358,-1
981,1,STEP,760831042966,760833755130,2712164,-1
982,1,STEP,760833829129,760836847889,3018760,-1
983,1,STEP,760836922088,760840040146,3118058,-1
984,1,STEP,760840115945,760842877108,2761163,-1
985,1,STEP,760842949207,760845754370,2805163,-1
986,1,STEP,760845826269,760848430634,2604365,-1
987,1,STEP,760848502033,760851712990,3210957,-1
988,1,STEP,760851787089,760854801249,3014160,-1
989,1,STEP,760854875248,760857755810,2880562,-1
990,1,STEP,760857828209,760860312776,2484567,-1
991,1,STEP,760860382675,760863330335,2947660,-1
992,1,STEP,760863404434,760866282696,2878262,-1
993,1,STEP,760866353695,760869248556,2894861,-1
994,1,STEP,760869320755,760872032019,2711264,-1
995,1,STEP,760872104618,760875607172,3502554,-1
996,1,STEP,760875682271,760878569732,2887461,-1
997,1,STEP,760878644231,760881725390,3081159,-1
998,1,STEP,760881800889,760884821749,3020860,-1
999,1,STEP,760884896848,760887966907,3070059,-1
