Gen,Resource,Stamp,TimeStamp_Start,TimeStamp_End,Duration,Indiv_id
0,1,FirstEvaluation,851366342983,852162233826,795890843,-1
0,1,STEP,852162427225,852168263768,5836543,-1
1,1,STEP,852168338268,852172784325,4446057,-1
2,1,STEP,852172853824,852177702377,4848553,-1
3,1,STEP,852177773977,852181962336,4188359,-1
4,1,STEP,852182033435,852185583401,3549966,-1
5,1,STEP,852185653801,852190810451,5156650,-1
6,1,STEP,852190881150,852195454806,4573656,-1
7,1,STEP,852195529205,852199658765,4129560,-1
8,1,STEP,852199728465,852203191431,3462966,-1
9,1,STEP,852203259031,852208063184,4804153,-1
10,1,STEP,852208168483,852211882848,3714365,-1
11,1,STEP,852211990447,852216833600,4843153,-1
12,1,STEP,852216944299,852221969150,5024851,-1
13,1,STEP,852222077249,852226534706,4457457,-1
14,1,STEP,852226645405,852230876964,4231559,-1
15,1,STEP,852230992163,852234228632,3236469,-1
16,1,STEP,852234338331,852238436291,4097960,-1
17,1,STEP,852238545390,852242638151,4092761,-1
18,1,STEP,852242747950,852246355015,3607065,-1
19,1,STEP,852246469814,852249519284,3049470,-1
20,1,STEP,852249627783,852253858543,4230760,-1
21,1,STEP,852253988741,852257477508,3488767,-1
22,1,STEP,852257584407,852260639177,3054770,-1
23,1,STEP,852260746976,852264701938,3954962,-1
24,1,STEP,852264804937,852269077496,4272559,-1
25,1,STEP,852269183195,852273054657,3871462,-1
26,1,STEP,852273166556,852277415015,4248459,-1
27,1,STEP,852277524514,852281646375,4121861,-1
28,1,STEP,852281754874,852285362839,3607965,-1
29,1,STEP,852285471838,852290147293,4675455,-1
30,1,STEP,852290258491,852293955456,3696965,-1
31,1,STEP,852294064655,852297747819,3683164,-1
32,1,STEP,852297887118,852301669981,3782863,-1
33,1,STEP,852301780880,852305047449,3266569,-1
34,1,STEP,852305152748,852308786913,3634165,-1
35,1,STEP,852308895312,852312085681,3190369,-1
36,1,STEP,852312195480,852315687146,3491666,-1
37,1,STEP,852315797545,852318859616,3062071,-1
38,1,STEP,852318967915,852321781487,2813572,-1
39,1,STEP,852321899686,852324963257,3063571,-1
40,1,STEP,852325070956,852328432623,3361667,-1
41,1,STEP,852328543422,852331836990,3293568,-1
42,1,STEP,852331947489,852335783552,3836063,-1
43,1,STEP,852335895451,852338966222,3070771,-1
44,1,STEP,852339074521,852342247690,3173169,-1
45,1,STEP,852342357689,852345791656,3433967,-1
46,1,STEP,852345913655,852348952625,3038970,-1
47,1,STEP,852349062724,852351883097,2820373,-1
48,1,STEP,852351993096,852355003667,3010571,-1
49,1,STEP,852355113066,852357970438,2857372,-1
50,1,STEP,852358082837,852361959200,3876363,-1
51,1,STEP,852362096998,852366378957,4281959,-1
52,1,STEP,852366453056,852369745425,3292369,-1
53,1,STEP,852369816524,852373245591,3429067,-1
54,1,STEP,852373326990,852376902256,3575266,-1
55,1,STEP,852376986155,852380665819,3679664,-1
56,1,STEP,852380745719,852383989887,3244168,-1
57,1,STEP,852384067887,852386748561,2680674,-1
58,1,STEP,852386823960,852389274736,2450776,-1
59,1,STEP,852389353536,852391828912,2475376,-1
60,1,STEP,852391904411,852394566085,2661674,-1
61,1,STEP,852394642985,852397752955,3109970,-1
62,1,STEP,852397829154,852400711126,2881972,-1
63,1,STEP,852400789525,852404292891,3503366,-1
64,1,STEP,852404428290,852408973946,4545656,-1
65,1,STEP,852409048546,852412614811,3566265,-1
66,1,STEP,852412686610,852415065587,2378977,-1
67,1,STEP,852415136687,852418341956,3205269,-1
68,1,STEP,852418415055,852421338327,2923272,-1
69,1,STEP,852421410526,852424128900,2718374,-1
70,1,STEP,852424200999,852426787074,2586075,-1
71,1,STEP,852426859374,852429839745,2980371,-1
72,1,STEP,852429933844,852433117813,3183969,-1
73,1,STEP,852433190613,852436623380,3432767,-1
74,1,STEP,852436696779,852440015847,3319068,-1
75,1,STEP,852440087146,852443228116,3140970,-1
76,1,STEP,852443346215,852446127988,2781773,-1
77,1,STEP,852446247187,852449152259,2905072,-1
78,1,STEP,852449264158,852452210929,2946771,-1
79,1,STEP,852452326928,852455118301,2791373,-1
80,1,STEP,852455235700,852458334770,3099070,-1
81,1,STEP,852458446569,852461156043,2709474,-1
82,1,STEP,852461266742,852464328612,3061870,-1
83,1,STEP,852464442811,852467340383,2897572,-1
84,1,STEP,852467458882,852470595452,3136570,-1
85,1,STEP,852470725051,852473600423,2875372,-1
86,1,STEP,852473718222,852476846492,3128270,-1
87,1,STEP,852476972390,852480029661,3057271,-1
88,1,STEP,852480142360,852483132031,2989671,-1
89,1,STEP,852483245930,852486066103,2820173,-1
90,1,STEP,852486182901,852489458770,3275869,-1
91,1,STEP,852489571169,852493056035,3484866,-1
92,1,STEP,852493170634,852496485602,3314968,-1
93,1,STEP,852496600101,852499210676,2610575,-1
94,1,STEP,852499325275,852502217947,2892672,-1
95,1,STEP,852502332546,852505589714,3257168,-1
96,1,STEP,852505703113,852508642085,2938972,-1
97,1,STEP,852508757384,852511626156,2868772,-1
98,1,STEP,852511739755,852514628027,2888272,-1
99,1,STEP,852514741226,852517859596,3118370,-1
100,1,STEP,852517985395,852520644969,2659574,-1
101,1,STEP,852520756368,852523691240,2934872,-1
102,1,STEP,852523804639,852526849009,3044370,-1
103,1,STEP,852526964808,852529731281,2766473,-1
104,1,STEP,852529843780,852532630953,2787173,-1
105,1,STEP,852532743852,852536137320,3393468,-1
106,1,STEP,852536251718,852539446688,3194970,-1
107,1,STEP,852539560787,852542580157,3019370,-1
108,1,STEP,852542685756,852546058824,3373068,-1
109,1,STEP,852546163823,852549130094,2966271,-1
110,1,STEP,852549233693,852552282164,3048471,-1
111,1,STEP,852552392163,852555412534,3020371,-1
112,1,STEP,852555523233,852558336905,2813672,-1
113,1,STEP,852558449304,852561122979,2673675,-1
114,1,STEP,852561227978,852564327948,3099970,-1
115,1,STEP,852564447846,852567194520,2746674,-1
116,1,STEP,852567307119,852570568387,3261268,-1
117,1,STEP,852570678786,852573769557,3090771,-1
118,1,STEP,852573891255,852577319522,3428267,-1
119,1,STEP,852577433521,852581018087,3584566,-1
120,1,STEP,852581133585,852584571052,3437467,-1
121,1,STEP,852584684651,852587924620,3239969,-1
122,1,STEP,852588037519,852591099989,3062470,-1
123,1,STEP,852591210988,852594159860,2948872,-1
124,1,STEP,852594270559,852597406829,3136270,-1
125,1,STEP,852597532027,852600374400,2842373,-1
126,1,STEP,852600483199,852603441570,2958371,-1
127,1,STEP,852603556469,852606946336,3389867,-1
128,1,STEP,852607134035,852610431203,3297168,-1
129,1,STEP,852610536702,852613467274,2930572,-1
130,1,STEP,852613575073,852616383745,2808672,-1
131,1,STEP,852616491044,852619426516,2935472,-1
132,1,STEP,852619534215,852622336788,2802573,-1
133,1,STEP,852622446987,852625465658,3018671,-1
134,1,STEP,852625571957,852629004824,3432867,-1
135,1,STEP,852629113523,852632289292,3175769,-1
136,1,STEP,852632399891,852635232064,2832173,-1
137,1,STEP,852635342263,852638918828,3576565,-1
138,1,STEP,852639028227,852642110297,3082070,-1
139,1,STEP,852642216796,852645171368,2954572,-1
140,1,STEP,852645277367,852648455336,3177969,-1
141,1,STEP,852648576235,852651828404,3252169,-1
142,1,STEP,852651937202,852655712466,3775264,-1
143,1,STEP,852655819365,852658899535,3080170,-1
144,1,STEP,852659009734,852661475310,2465576,-1
145,1,STEP,852661582909,852665309573,3726664,-1
146,1,STEP,852665422972,852668303945,2880973,-1
147,1,STEP,852668413944,852671239016,2825072,-1
148,1,STEP,852671350515,852674316987,2966472,-1
149,1,STEP,852674424986,852677989951,3564965,-1
150,1,STEP,852678101850,852681235220,3133370,-1
151,1,STEP,852681340119,852684733486,3393367,-1
152,1,STEP,852684837685,852688077054,3239369,-1
153,1,STEP,852688184153,852690881227,2697074,-1
154,1,STEP,852690989726,852693966497,2976771,-1
155,1,STEP,852694074896,852697289165,3214269,-1
156,1,STEP,852697393064,852700060638,2667574,-1
157,1,STEP,852700168437,852703792302,3623865,-1
158,1,STEP,852703912101,852707989262,4077161,-1
159,1,STEP,852708102761,852711251030,3148269,-1
160,1,STEP,852711362729,852714807596,3444867,-1
161,1,STEP,852714918895,852718722358,3803463,-1
162,1,STEP,852718833257,852722120325,3287068,-1
163,1,STEP,852722231524,852725061697,2830173,-1
164,1,STEP,852725176196,852728358365,3182169,-1
165,1,STEP,852728467364,852731479135,3011771,-1
166,1,STEP,852731589434,852734615905,3026471,-1
167,1,STEP,852734726204,852737729775,3003571,-1
168,1,STEP,852737839174,852741045443,3206269,-1
169,1,STEP,852741157842,852744102213,2944371,-1
170,1,STEP,852744197912,852747089685,2891773,-1
171,1,STEP,852747186684,852750189755,3003071,-1
172,1,STEP,852750269454,852752929028,2659574,-1
173,1,STEP,852753006227,852756127097,3120870,-1
174,1,STEP,852756215097,852759559564,3344467,-1
175,1,STEP,852759653263,852762490636,2837373,-1
176,1,STEP,852762576335,852765822104,3245769,-1
177,1,STEP,852765936703,852769031173,3094470,-1
178,1,STEP,852769118072,852771757447,2639375,-1
179,1,STEP,852771838446,852775340212,3501766,-1
180,1,STEP,852775422911,852778125685,2702774,-1
181,1,STEP,852778209984,852780887259,2677275,-1
182,1,STEP,852780966858,852783750631,2783773,-1
183,1,STEP,852783836630,852786766902,2930272,-1
184,1,STEP,852786878001,852790264668,3386667,-1
185,1,STEP,852790349167,852793633736,3284569,-1
186,1,STEP,852793718735,852796245410,2526675,-1
187,1,STEP,852796329110,852799311681,2982571,-1
188,1,STEP,852799398880,852802362551,2963671,-1
189,1,STEP,852802447551,852804997626,2550075,-1
190,1,STEP,852805081925,852807804499,2722574,-1
191,1,STEP,852807888898,852810944069,3055171,-1
192,1,STEP,852811029468,852813581943,2552475,-1
193,1,STEP,852813661142,852816498215,2837073,-1
194,1,STEP,852816585914,852819372387,2786473,-1
195,1,STEP,852819454186,852822326259,2872073,-1
196,1,STEP,852822411858,852826021123,3609265,-1
197,1,STEP,852826105822,852828964895,2859073,-1
198,1,STEP,852829051394,852832131664,3080270,-1
199,1,STEP,852832214263,852835379633,3165370,-1
200,1,STEP,852835460532,852838356104,2895572,-1
201,1,STEP,852838437403,852841349175,2911772,-1
202,1,STEP,852841428575,852844598144,3169569,-1
203,1,STEP,852844678543,852847494916,2816373,-1
204,1,STEP,852847576715,852850828484,3251769,-1
205,1,STEP,852850916883,852853894754,2977871,-1
206,1,STEP,852853976653,852857674918,3698265,-1
207,1,STEP,852857756517,852860737288,2980771,-1
208,1,STEP,852860818087,852863806759,2988672,-1
209,1,STEP,852863889858,852866978028,3088170,-1
210,1,STEP,852867075527,852869578203,2502676,-1
211,1,STEP,852869656602,852872818172,3161570,-1
212,1,STEP,852872900971,852876154940,3253969,-1
213,1,STEP,852876236939,852879728405,3491466,-1
214,1,STEP,852879811304,852883105272,3293968,-1
215,1,STEP,852883187872,852885954845,2766973,-1
216,1,STEP,852886035044,852889450911,3415867,-1
217,1,STEP,852889532210,852892566481,3034271,-1
218,1,STEP,852892648080,852895881049,3232969,-1
219,1,STEP,852895961548,852898876620,2915072,-1
220,1,STEP,852898987819,852902349087,3361268,-1
221,1,STEP,852902421786,852905317958,2896172,-1
222,1,STEP,852905388158,852909009523,3621365,-1
223,1,STEP,852909082022,852912468089,3386067,-1
224,1,STEP,852912540489,852915666658,3126169,-1
225,1,STEP,852915738158,852918821528,3083370,-1
226,1,STEP,852918892527,852921765600,2873073,-1
227,1,STEP,852921835199,852924815470,2980271,-1
228,1,STEP,852924923469,852927675243,2751774,-1
229,1,STEP,852927787941,852930747813,2959872,-1
230,1,STEP,852930863112,852934218979,3355867,-1
231,1,STEP,852934333978,852937338549,3004571,-1
232,1,STEP,852937450148,852939958424,2508276,-1
233,1,STEP,852940072023,852943273692,3201669,-1
234,1,STEP,852943392791,852946245163,2852372,-1
235,1,STEP,852946378162,852950171525,3793363,-1
236,1,STEP,852950248925,852953081897,2832972,-1
237,1,STEP,852953191396,852956642063,3450667,-1
238,1,STEP,852956754662,852959445336,2690674,-1
239,1,STEP,852959558235,852962764104,3205869,-1
240,1,STEP,852962878403,852966288270,3409867,-1
241,1,STEP,852966401069,852969565638,3164569,-1
242,1,STEP,852969679237,852972667708,2988471,-1
243,1,STEP,852972781407,852976012976,3231569,-1
244,1,STEP,852976127975,852979484543,3356568,-1
245,1,STEP,852979599242,852983278006,3678764,-1
246,1,STEP,852983393305,852985805482,2412177,-1
247,1,STEP,852985927581,852989009951,3082370,-1
248,1,STEP,852989115150,852992200120,3084970,-1
249,1,STEP,852992283219,852995325790,3042571,-1
250,1,STEP,852995409889,852999087154,3677265,-1
251,1,STEP,852999186953,853002253323,3066370,-1
252,1,STEP,853002336322,853005542491,3206169,-1
253,1,STEP,853005628791,853008271665,2642874,-1
254,1,STEP,853008361164,853011414535,3053371,-1
255,1,STEP,853011504834,853014526805,3021971,-1
256,1,STEP,853014660503,853017695374,3034871,-1
257,1,STEP,853017784873,853021077641,3292768,-1
258,1,STEP,853021173941,853023786215,2612274,-1
259,1,STEP,853023866915,853027046684,3179769,-1
260,1,STEP,853027129683,853030771348,3641665,-1
261,1,STEP,853030854747,853033774519,2919772,-1
262,1,STEP,853033855718,853036815690,2959972,-1
263,1,STEP,853036904889,853040755252,3850363,-1
264,1,STEP,853040844051,853043909621,3065570,-1
265,1,STEP,853043997420,853046561896,2564476,-1
266,1,STEP,853046645895,853049832564,3186669,-1
267,1,STEP,853049944163,853053344630,3400467,-1
268,1,STEP,853053446129,853055939005,2492876,-1
269,1,STEP,853056021704,853059153174,3131470,-1
270,1,STEP,853059255173,853062623641,3368468,-1
271,1,STEP,853062724940,853066143807,3418867,-1
272,1,STEP,853066239806,853069418075,3178269,-1
273,1,STEP,853069506374,853072028150,2521776,-1
274,1,STEP,853072116649,853074772424,2655775,-1
275,1,STEP,853074855323,853078211490,3356167,-1
276,1,STEP,853078297190,853081503759,3206569,-1
277,1,STEP,853081586558,853084548429,2961871,-1
278,1,STEP,853084638128,853087731398,3093270,-1
279,1,STEP,853087819898,853090924968,3105070,-1
280,1,STEP,853091013967,853094293635,3279668,-1
281,1,STEP,853094385734,853097028109,2642375,-1
282,1,STEP,853097112808,853100030780,2917972,-1
283,1,STEP,853100116279,853103044851,2928572,-1
284,1,STEP,853103130950,853106298519,3167569,-1
285,1,STEP,853106383619,853109593188,3209569,-1
286,1,STEP,853109678187,853112922555,3244368,-1
287,1,STEP,853113008355,853115991026,2982671,-1
288,1,STEP,853116081225,853119212695,3131470,-1
289,1,STEP,853119304294,853121789070,2484776,-1
290,1,STEP,853121888369,853124895340,3006971,-1
291,1,STEP,853124985939,853127786712,2800773,-1
292,1,STEP,853127878111,853131182879,3304768,-1
293,1,STEP,853131274578,853134350649,3076071,-1
294,1,STEP,853134453348,853137598517,3145169,-1
295,1,STEP,853137689317,853142414671,4725354,-1
296,1,STEP,853142506070,853145439742,2933672,-1
297,1,STEP,853145522841,853148606911,3084070,-1
298,1,STEP,853148705410,853152058578,3353168,-1
299,1,STEP,853152157677,853155392246,3234569,-1
300,1,STEP,853155518945,853158633215,3114270,-1
301,1,STEP,853158734114,853161201790,2467676,-1
302,1,STEP,853161290189,853164283560,2993371,-1
303,1,STEP,853164375859,853167334631,2958772,-1
304,1,STEP,853167425930,853170523000,3097070,-1
305,1,STEP,853170622899,853173691269,3068370,-1
306,1,STEP,853173784268,853177157836,3373568,-1
307,1,STEP,853177252135,853179957409,2705274,-1
308,1,STEP,853180050008,853182996379,2946371,-1
309,1,STEP,853183089579,853185542455,2452876,-1
310,1,STEP,853185633354,853189024121,3390767,-1
311,1,STEP,853189116520,853192272090,3155570,-1
312,1,STEP,853192367789,853195445959,3078170,-1
313,1,STEP,853195537259,853198581929,3044670,-1
314,1,STEP,853198680728,853201591500,2910772,-1
315,1,STEP,853201684599,853204677770,2993171,-1
316,1,STEP,853204771369,853207618342,2846973,-1
317,1,STEP,853207715841,853210482414,2766573,-1
318,1,STEP,853210574713,853213665984,3091271,-1
319,1,STEP,853213758083,853216995252,3237169,-1
320,1,STEP,853217094751,853220120421,3025670,-1
321,1,STEP,853220217020,853223534488,3317468,-1
322,1,STEP,853223627488,853226664258,3036770,-1
323,1,STEP,853226758457,853230086425,3327968,-1
324,1,STEP,853230178224,853232894398,2716174,-1
325,1,STEP,853232985397,853236230466,3245069,-1
326,1,STEP,853236326365,853239682833,3356468,-1
327,1,STEP,853239780432,853242664504,2884072,-1
328,1,STEP,853242762503,853245306478,2543975,-1
329,1,STEP,853245397978,853248371549,2973571,-1
330,1,STEP,853248469348,853251533718,3064370,-1
331,1,STEP,853251632417,853254645088,3012671,-1
332,1,STEP,853254736187,853257297463,2561276,-1
333,1,STEP,853257389262,853260665930,3276668,-1
334,1,STEP,853260758929,853263865399,3106470,-1
335,1,STEP,853263961798,853266852871,2891073,-1
336,1,STEP,853266949270,853270098039,3148769,-1
337,1,STEP,853270195238,853273189309,2994071,-1
338,1,STEP,853273288908,853276800575,3511667,-1
339,1,STEP,853276913174,853280448239,3535065,-1
340,1,STEP,853280544838,853284231703,3686865,-1
341,1,STEP,853284326202,853287673770,3347568,-1
342,1,STEP,853287789469,853291158236,3368767,-1
343,1,STEP,853291253035,853294625003,3371968,-1
344,1,STEP,853294717302,853298056570,3339268,-1
345,1,STEP,853298155669,853301115640,2959971,-1
346,1,STEP,853301207339,853304277810,3070471,-1
347,1,STEP,853304375709,853307444579,3068870,-1
348,1,STEP,853307537178,853311667538,4130360,-1
349,1,STEP,853311808837,853315255504,3446667,-1
350,1,STEP,853315330603,853318738270,3407667,-1
351,1,STEP,853318824069,853322287536,3463467,-1
352,1,STEP,853322411835,853325947400,3535565,-1
353,1,STEP,853326066999,853329807463,3740464,-1
354,1,STEP,853329909862,853333222830,3312968,-1
355,1,STEP,853333343329,853336967994,3624665,-1
356,1,STEP,853337087393,853340167863,3080470,-1
357,1,STEP,853340288662,853343378732,3090070,-1
358,1,STEP,853343453232,853346349304,2896072,-1
359,1,STEP,853346423703,853349530373,3106670,-1
360,1,STEP,853349604572,853353116038,3511466,-1
361,1,STEP,853353200138,853356226808,3026670,-1
362,1,STEP,853356302808,853359102881,2800073,-1
363,1,STEP,853359216280,853361984453,2768173,-1
364,1,STEP,853362101052,853365170122,3069070,-1
365,1,STEP,853365284921,853368480990,3196069,-1
366,1,STEP,853368594289,853371986056,3391767,-1
367,1,STEP,853372101055,853375080027,2978972,-1
368,1,STEP,853375201425,853378042798,2841373,-1
369,1,STEP,853378160197,853381186368,3026171,-1
370,1,STEP,853381309166,853383957741,2648575,-1
371,1,STEP,853384032440,853387476407,3443967,-1
372,1,STEP,853387560706,853390916674,3355968,-1
373,1,STEP,853390996573,853393896545,2899972,-1
374,1,STEP,853393969844,853396898216,2928372,-1
375,1,STEP,853396975715,853399872587,2896872,-1
376,1,STEP,853399952387,853402695560,2743173,-1
377,1,STEP,853402777559,853405732431,2954872,-1
378,1,STEP,853405818830,853408566603,2747773,-1
379,1,STEP,853408644403,853411610574,2966171,-1
380,1,STEP,853411697373,853414838143,3140770,-1
381,1,STEP,853414918042,853417544617,2626575,-1
382,1,STEP,853417629416,853420964484,3335068,-1
383,1,STEP,853421045583,853424003855,2958272,-1
384,1,STEP,853424089054,853427258923,3169869,-1
385,1,STEP,853427333422,853430328894,2995472,-1
386,1,STEP,853430412893,853433634062,3221169,-1
387,1,STEP,853433715461,853436789431,3073970,-1
388,1,STEP,853436874230,853440058000,3183770,-1
389,1,STEP,853440134299,853442870173,2735874,-1
390,1,STEP,853442949272,853446094341,3145069,-1
391,1,STEP,853446166941,853449297111,3130170,-1
392,1,STEP,853449369310,853452543679,3174369,-1
393,1,STEP,853452619479,853455678149,3058670,-1
394,1,STEP,853455751148,853458808919,3057771,-1
395,1,STEP,853458877218,853462234386,3357168,-1
396,1,STEP,853462309585,853465296756,2987171,-1
397,1,STEP,853465368056,853468091029,2722973,-1
398,1,STEP,853468162829,853471149400,2986571,-1
399,1,STEP,853471222399,853474697366,3474967,-1
400,1,STEP,853474771565,853477704037,2932472,-1
401,1,STEP,853477775736,853480507509,2731773,-1
402,1,STEP,853480578009,853482943886,2365877,-1
403,1,STEP,853483014385,853486062556,3048171,-1
404,1,STEP,853486134955,853488667331,2532376,-1
405,1,STEP,853488737130,853491591403,2854273,-1
406,1,STEP,853491662902,853494424275,2761373,-1
407,1,STEP,853494496975,853497631544,3134569,-1
408,1,STEP,853497701844,853500926413,3224569,-1
409,1,STEP,853500999712,853504323380,3323668,-1
410,1,STEP,853504396679,853507235752,2839073,-1
411,1,STEP,853507307451,853510510520,3203069,-1
412,1,STEP,853510583019,853513231694,2648675,-1
413,1,STEP,853513312393,853516753660,3441267,-1
414,1,STEP,853516827259,853519689732,2862473,-1
415,1,STEP,853519761431,853522122208,2360777,-1
416,1,STEP,853522193507,853525242178,3048671,-1
417,1,STEP,853525312877,853527922552,2609675,-1
418,1,STEP,853527993351,853530967923,2974572,-1
419,1,STEP,853531040122,853534002693,2962571,-1
420,1,STEP,853534074693,853536752067,2677374,-1
421,1,STEP,853536821966,853539711738,2889772,-1
422,1,STEP,853539786038,853543124605,3338567,-1
423,1,STEP,853543197705,853546260775,3063070,-1
424,1,STEP,853546332475,853549030748,2698273,-1
425,1,STEP,853549099548,853552082519,2982971,-1
426,1,STEP,853552176818,853555755484,3578666,-1
427,1,STEP,853555888182,853558843454,2955272,-1
428,1,STEP,853558963153,853562794816,3831663,-1
429,1,STEP,853562913915,853566115584,3201669,-1
430,1,STEP,853566199583,853568968756,2769173,-1
431,1,STEP,853569049655,853572318924,3269269,-1
432,1,STEP,853572400623,853575972589,3571966,-1
433,1,STEP,853576106387,853580540345,4433958,-1
434,1,STEP,853580648043,853583397517,2749474,-1
435,1,STEP,853583509916,853586843984,3334068,-1
436,1,STEP,853586951683,853589790255,2838572,-1
437,1,STEP,853589906654,853593561019,3654365,-1
438,1,STEP,853593634918,853597467281,3832363,-1
439,1,STEP,853597609980,853602036837,4426857,-1
440,1,STEP,853602116236,853605515304,3399068,-1
441,1,STEP,853605661202,853608466175,2804973,-1
442,1,STEP,853608541174,853611769943,3228769,-1
443,1,STEP,853611841443,853615637206,3795763,-1
444,1,STEP,853615712205,853618958874,3246669,-1
445,1,STEP,853619032573,853621518549,2485976,-1
446,1,STEP,853621587349,853624918316,3330967,-1
447,1,STEP,853624987316,853627784189,2796873,-1
448,1,STEP,853627857988,853630701061,2843073,-1
449,1,STEP,853630776060,853633594733,2818673,-1
450,1,STEP,853633665932,853636445305,2779373,-1
451,1,STEP,853636517005,853639547675,3030670,-1
452,1,STEP,853639622175,853643273439,3651264,-1
453,1,STEP,853643414638,853647410399,3995761,-1
454,1,STEP,853647488399,853650481970,2993571,-1
455,1,STEP,853650553269,853653626039,3072770,-1
456,1,STEP,853653697239,853656689910,2992671,-1
457,1,STEP,853656763009,853659681281,2918272,-1
458,1,STEP,853659753080,853662681452,2928372,-1
459,1,STEP,853662751151,853665978020,3226869,-1
460,1,STEP,853666052420,853669092390,3039970,-1
461,1,STEP,853669164490,853672234660,3070170,-1
462,1,STEP,853672308959,853675256731,2947772,-1
463,1,STEP,853675329130,853678589899,3260769,-1
464,1,STEP,853678663798,853681890867,3227069,-1
465,1,STEP,853681960266,853685473632,3513366,-1
466,1,STEP,853685546832,853688812300,3265468,-1
467,1,STEP,853688885299,853692105368,3220069,-1
468,1,STEP,853692178668,853695563835,3385167,-1
469,1,STEP,853695637634,853699005302,3367668,-1
470,1,STEP,853699079501,853702624367,3544866,-1
471,1,STEP,853702698066,853705603338,2905272,-1
472,1,STEP,853705673437,853709313002,3639565,-1
473,1,STEP,853709388202,853712685970,3297768,-1
474,1,STEP,853712759569,853716402934,3643365,-1
475,1,STEP,853716477133,853719283006,2805873,-1
476,1,STEP,853719355305,853722345777,2990472,-1
477,1,STEP,853722419476,853725558446,3138970,-1
478,1,STEP,853725628945,853729132211,3503266,-1
479,1,STEP,853729205910,853732205081,2999171,-1
480,1,STEP,853732276281,853735138553,2862272,-1
481,1,STEP,853735211352,853738228323,3016971,-1
482,1,STEP,853738302223,853740807098,2504875,-1
483,1,STEP,853740877698,853743811269,2933571,-1
484,1,STEP,853743884469,853746801841,2917372,-1
485,1,STEP,853746875340,853750305107,3429767,-1
486,1,STEP,853750378706,853753123880,2745174,-1
487,1,STEP,853753195379,853756049151,2853772,-1
488,1,STEP,853756122451,853759596717,3474266,-1
489,1,STEP,853759672116,853762910185,3238069,-1
490,1,STEP,853762983585,853765966156,2982571,-1
491,1,STEP,853766041555,853768745729,2704174,-1
492,1,STEP,853768816728,853772191096,3374368,-1
493,1,STEP,853772264995,853774820270,2555275,-1
494,1,STEP,853774891570,853777598044,2706474,-1
495,1,STEP,853777666143,853780316017,2649874,-1
496,1,STEP,853780384817,853783243589,2858772,-1
497,1,STEP,853783314888,853786245860,2930972,-1
498,1,STEP,853786318259,853790103923,3785664,-1
499,1,STEP,853790176522,853793329092,3152570,-1
500,1,STEP,853793400391,853796658160,3257769,-1
501,1,STEP,853796731259,853799443633,2712374,-1
502,1,STEP,853799516732,853802503803,2987071,-1
503,1,STEP,853802575703,853805649873,3074170,-1
504,1,STEP,853805720472,853808698644,2978172,-1
505,1,STEP,853808772543,853811679115,2906572,-1
506,1,STEP,853811752814,853814491588,2738774,-1
507,1,STEP,853814559287,853817551058,2991771,-1
508,1,STEP,853817620957,853820621129,3000172,-1
509,1,STEP,853820689728,853823557200,2867472,-1
510,1,STEP,853823630599,853826496172,2865573,-1
511,1,STEP,853826569071,853829553642,2984571,-1
512,1,STEP,853829663041,853832597913,2934872,-1
513,1,STEP,853832669312,853835341387,2672075,-1
514,1,STEP,853835412586,853838389957,2977371,-1
515,1,STEP,853838461756,853841181930,2720174,-1
516,1,STEP,853841251230,853845646387,4395157,-1
517,1,STEP,853845720486,853848799657,3079171,-1
518,1,STEP,853848872456,853852310923,3438467,-1
519,1,STEP,853852384522,853855580791,3196269,-1
520,1,STEP,853855653691,853859119957,3466266,-1
521,1,STEP,853859195656,853862544724,3349068,-1
522,1,STEP,853862621323,853865957391,3336068,-1
523,1,STEP,853866034390,853869378358,3343968,-1
524,1,STEP,853869451057,853872784625,3333568,-1
525,1,STEP,853872859125,853876392991,3533866,-1
526,1,STEP,853876467190,853879629959,3162769,-1
527,1,STEP,853879704359,853882626730,2922371,-1
528,1,STEP,853882701530,853885497403,2795873,-1
529,1,STEP,853885570902,853888858370,3287468,-1
530,1,STEP,853888932670,853892121739,3189069,-1
531,1,STEP,853892195738,853895533306,3337568,-1
532,1,STEP,853895608205,853898351279,2743074,-1
533,1,STEP,853898424078,853901609947,3185869,-1
534,1,STEP,853901682247,853904439420,2757173,-1
535,1,STEP,853904511219,853907620189,3108970,-1
536,1,STEP,853907693489,853910549661,2856172,-1
537,1,STEP,853910621760,853913237835,2616075,-1
538,1,STEP,853913307234,853917099098,3791864,-1
539,1,STEP,853917173497,853919649073,2475576,-1
540,1,STEP,853919717173,853922570245,2853072,-1
541,1,STEP,853922641844,853925988812,3346968,-1
542,1,STEP,853926061811,853928290190,2228379,-1
543,1,STEP,853928359689,853931427460,3067771,-1
544,1,STEP,853931499859,853934391831,2891972,-1
545,1,STEP,853934463230,853937796098,3332868,-1
546,1,STEP,853937879397,853940589571,2710174,-1
547,1,STEP,853940661871,853943950339,3288468,-1
548,1,STEP,853944024438,853947465905,3441467,-1
549,1,STEP,853947576704,853950723773,3147069,-1
550,1,STEP,853950839872,853954048141,3208269,-1
551,1,STEP,853954164840,853957205911,3041071,-1
552,1,STEP,853957320210,853960172582,2852372,-1
553,1,STEP,853960286081,853963507450,3221369,-1
554,1,STEP,853963623449,853967015416,3391967,-1
555,1,STEP,853967131115,853970383784,3252669,-1
556,1,STEP,853970501783,853973335255,2833472,-1
557,1,STEP,853973450454,853976241627,2791173,-1
558,1,STEP,853976358526,853979740594,3382068,-1
559,1,STEP,853979855692,853982724365,2868673,-1
560,1,STEP,853982837864,853985583437,2745573,-1
561,1,STEP,853985695936,853988272811,2576875,-1
562,1,STEP,853988380210,853991087684,2707474,-1
563,1,STEP,853991207983,853994436152,3228169,-1
564,1,STEP,853994552851,853998084517,3531666,-1
565,1,STEP,853998202915,854001268386,3065471,-1
566,1,STEP,854001383485,854004336356,2952871,-1
567,1,STEP,854004452455,854007674924,3222469,-1
568,1,STEP,854007790323,854010623396,2833073,-1
569,1,STEP,854010733695,854013784165,3050470,-1
570,1,STEP,854013910564,854017290231,3379667,-1
571,1,STEP,854017410230,854020869997,3459767,-1
572,1,STEP,854020963596,854023822468,2858872,-1
573,1,STEP,854023904568,854026865539,2960971,-1
574,1,STEP,854026950538,854030029308,3078770,-1
575,1,STEP,854030112308,854033186078,3073770,-1
576,1,STEP,854033269577,854036072250,2802673,-1
577,1,STEP,854036151849,854039148420,2996571,-1
578,1,STEP,854039230820,854042302390,3071570,-1
579,1,STEP,854042385589,854045420160,3034571,-1
580,1,STEP,854045499659,854048378431,2878772,-1
581,1,STEP,854048464531,854051135705,2671174,-1
582,1,STEP,854051217304,854054503672,3286368,-1
583,1,STEP,854054586172,854057208646,2622474,-1
584,1,STEP,854057290145,854060207217,2917072,-1
585,1,STEP,854060296816,854063270888,2974072,-1
586,1,STEP,854063352587,854066630555,3277968,-1
587,1,STEP,854066714755,854069848024,3133269,-1
588,1,STEP,854069947823,854073306391,3358568,-1
589,1,STEP,854073391290,854076273062,2881772,-1
590,1,STEP,854076352762,854079554531,3201769,-1
591,1,STEP,854079635130,854082797599,3162469,-1
592,1,STEP,854082880599,854086494764,3614165,-1
593,1,STEP,854086578263,854089498135,2919872,-1
594,1,STEP,854089586034,854092154709,2568675,-1
595,1,STEP,854092235008,854095077481,2842473,-1
596,1,STEP,854095166480,854097781055,2614575,-1
597,1,STEP,854097875454,854100687327,2811873,-1
598,1,STEP,854100779626,854103549399,2769773,-1
599,1,STEP,854103630098,854106991566,3361468,-1
600,1,STEP,854107078565,854110256035,3177470,-1
601,1,STEP,854110339434,854113526803,3187369,-1
602,1,STEP,854113616902,854116556674,2939772,-1
603,1,STEP,854116645373,854119718243,3072870,-1
604,1,STEP,854119808342,854122561316,2752974,-1
605,1,STEP,854122642815,854126192281,3549466,-1
606,1,STEP,854126274780,854129098553,2823773,-1
607,1,STEP,854129178852,854132211423,3032571,-1
608,1,STEP,854132292922,854135266193,2973271,-1
609,1,STEP,854135354092,854138355563,3001471,-1
610,1,STEP,854138437763,854141480133,3042370,-1
611,1,STEP,854141564632,854144167207,2602575,-1
612,1,STEP,854144255107,854147088879,2833772,-1
613,1,STEP,854147175478,854149803653,2628175,-1
614,1,STEP,854149907252,854153169021,3261769,-1
615,1,STEP,854153252020,854156174392,2922372,-1
616,1,STEP,854156260191,854159019564,2759373,-1
617,1,STEP,854159106363,854161598439,2492076,-1
618,1,STEP,854161683138,854164724609,3041471,-1
619,1,STEP,854164807408,854167942278,3134870,-1
620,1,STEP,854168025277,854171100048,3074771,-1
621,1,STEP,854171188647,854173940420,2751773,-1
622,1,STEP,854174021719,854176812992,2791273,-1
623,1,STEP,854176894892,854179968062,3073170,-1
624,1,STEP,854180050861,854183338030,3287169,-1
625,1,STEP,854183420929,854186657797,3236868,-1
626,1,STEP,854186740897,854189626869,2885972,-1
627,1,STEP,854189707168,854192905337,3198169,-1
628,1,STEP,854192987836,854196193805,3205969,-1
629,1,STEP,854196279005,854199199076,2920071,-1
630,1,STEP,854199280876,854202818442,3537566,-1
631,1,STEP,854202902341,854205725414,2823073,-1
632,1,STEP,854205807113,854208794184,2987071,-1
633,1,STEP,854208876283,854211881054,3004771,-1
634,1,STEP,854211962653,854214934825,2972172,-1
635,1,STEP,854215016824,854217889896,2873072,-1
636,1,STEP,854217973595,854220435272,2461677,-1
637,1,STEP,854220514571,854223995537,3480966,-1
638,1,STEP,854224080136,854227299405,3219269,-1
639,1,STEP,854227385105,854230103978,2718873,-1
640,1,STEP,854230189878,854233095750,2905872,-1
641,1,STEP,854233177349,854236244919,3067570,-1
642,1,STEP,854236332218,854239269590,2937372,-1
643,1,STEP,854239352589,854242249461,2896872,-1
644,1,STEP,854242330660,854245558129,3227469,-1
645,1,STEP,854245642428,854248716699,3074271,-1
646,1,STEP,854248803698,854251843469,3039771,-1
647,1,STEP,854251930768,854255338435,3407667,-1
648,1,STEP,854255426934,854258453105,3026171,-1
649,1,STEP,854258540204,854262095370,3555166,-1
650,1,STEP,854262179169,854265096341,2917172,-1
651,1,STEP,854265178240,854267882514,2704274,-1
652,1,STEP,854267964913,854271143582,3178669,-1
653,1,STEP,854271226682,854273847356,2620674,-1
654,1,STEP,854273948855,854277067425,3118570,-1
655,1,STEP,854277150425,854280376593,3226168,-1
656,1,STEP,854280458293,854283542063,3083770,-1
657,1,STEP,854283623662,854286632833,3009171,-1
658,1,STEP,854286715232,854289346607,2631375,-1
659,1,STEP,854289432606,854292757374,3324768,-1
660,1,STEP,854292839773,854296217941,3378168,-1
661,1,STEP,854296302740,854299585308,3282568,-1
662,1,STEP,854299669007,854302681978,3012971,-1
663,1,STEP,854302764277,854306004246,3239969,-1
664,1,STEP,854306089245,854309115216,3025971,-1
665,1,STEP,854309196715,854312609882,3413167,-1
666,1,STEP,854312694182,854315724152,3029970,-1
667,1,STEP,854315845951,854319137719,3291768,-1
668,1,STEP,854319227319,854321995292,2767973,-1
669,1,STEP,854322077591,854324596667,2519076,-1
670,1,STEP,854324676466,854328445530,3769064,-1
671,1,STEP,854328530529,854331854597,3324068,-1
672,1,STEP,854331944096,854335144765,3200669,-1
673,1,STEP,854335226964,854338013537,2786573,-1
674,1,STEP,854338095037,854340937009,2841972,-1
675,1,STEP,854341020708,854344197978,3177270,-1
676,1,STEP,854344279077,854347044150,2765073,-1
677,1,STEP,854347125449,854350219920,3094471,-1
678,1,STEP,854350308519,854352754095,2445576,-1
679,1,STEP,854352837494,854355985464,3147970,-1
680,1,STEP,854356068663,854359519630,3450967,-1
681,1,STEP,854359603429,854362827898,3224469,-1
682,1,STEP,854362911397,854366351864,3440467,-1
683,1,STEP,854366439263,854369647932,3208669,-1
684,1,STEP,854369731331,854372728203,2996872,-1
685,1,STEP,854372809602,854376207169,3397567,-1
686,1,STEP,854376290668,854379098041,2807373,-1
687,1,STEP,854379179240,854382563208,3383968,-1
688,1,STEP,854382647507,854385481079,2833572,-1
689,1,STEP,854385562179,854388770348,3208169,-1
690,1,STEP,854388853347,854391766319,2912972,-1
691,1,STEP,854391847518,854394922988,3075470,-1
692,1,STEP,854395006488,854398870650,3864162,-1
693,1,STEP,854398954950,854401519525,2564575,-1
694,1,STEP,854401599324,854404394697,2795373,-1
695,1,STEP,854404475196,854407222970,2747774,-1
696,1,STEP,854407304669,854410073842,2769173,-1
697,1,STEP,854410173841,854412889115,2715274,-1
698,1,STEP,854412973614,854416044085,3070471,-1
699,1,STEP,854416129784,854419296953,3167169,-1
700,1,STEP,854419387552,854422513122,3125570,-1
701,1,STEP,854422596221,854425597493,3001272,-1
702,1,STEP,854425678192,854428957360,3279168,-1
703,1,STEP,854429043859,854431695234,2651375,-1
704,1,STEP,854431776433,854434792504,3016071,-1
705,1,STEP,854434876103,854437418378,2542275,-1
706,1,STEP,854437494378,854440020453,2526075,-1
707,1,STEP,854440101453,854442998025,2896572,-1
708,1,STEP,854443081424,854446125394,3043970,-1
709,1,STEP,854446209394,854449280764,3071370,-1
710,1,STEP,854449364563,854452674631,3310068,-1
711,1,STEP,854452760830,854455599603,2838773,-1
712,1,STEP,854455732302,854459611064,3878762,-1
713,1,STEP,854459688664,854463489127,3800463,-1
714,1,STEP,854463566726,854466653796,3087070,-1
715,1,STEP,854466727496,854469918065,3190569,-1
716,1,STEP,854469994264,854473034935,3040671,-1
717,1,STEP,854473109334,854475971507,2862173,-1
718,1,STEP,854476046506,854478767880,2721374,-1
719,1,STEP,854478842379,854482176247,3333868,-1
720,1,STEP,854482251746,854485565014,3313268,-1
721,1,STEP,854485638213,854488538885,2900672,-1
722,1,STEP,854488609685,854492127151,3517466,-1
723,1,STEP,854492200750,854495205621,3004871,-1
724,1,STEP,854495278020,854498691487,3413467,-1
725,1,STEP,854498764587,854502031355,3266768,-1
726,1,STEP,854502105454,854505096226,2990772,-1
727,1,STEP,854505167925,854508286495,3118570,-1
728,1,STEP,854508359194,854511373965,3014771,-1
729,1,STEP,854511446964,854514883531,3436567,-1
730,1,STEP,854514957430,854518653895,3696465,-1
731,1,STEP,854518727894,854521828464,3100570,-1
732,1,STEP,854521937063,854524729636,2792573,-1
733,1,STEP,854524802336,854527637908,2835572,-1
734,1,STEP,854527709907,854530279783,2569876,-1
735,1,STEP,854530350382,854532987257,2636875,-1
736,1,STEP,854533058056,854536044327,2986271,-1
737,1,STEP,854536114526,854538793401,2678875,-1
738,1,STEP,854538882900,854541839871,2956971,-1
739,1,STEP,854541933670,854545027440,3093770,-1
740,1,STEP,854545111240,854547896713,2785473,-1
741,1,STEP,854547978812,854550757085,2778273,-1
742,1,STEP,854550863284,854554014254,3150970,-1
743,1,STEP,854554100853,854557736518,3635665,-1
744,1,STEP,854557822617,854560833488,3010871,-1
745,1,STEP,854560915287,854564285555,3370268,-1
746,1,STEP,854564373054,854567491224,3118170,-1
747,1,STEP,854567577523,854570194998,2617475,-1
748,1,STEP,854570280097,854573418667,3138570,-1
749,1,STEP,854573490666,854575913942,2423276,-1
750,1,STEP,854575984942,854579148811,3163869,-1
751,1,STEP,854579221511,854582397780,3176269,-1
752,1,STEP,854582469579,854585405851,2936272,-1
753,1,STEP,854585476950,854588039725,2562775,-1
754,1,STEP,854588112025,854591384493,3272468,-1
755,1,STEP,854591456993,854594056667,2599674,-1
756,1,STEP,854594145067,854597274736,3129669,-1
757,1,STEP,854597413135,854600329007,2915872,-1
758,1,STEP,854600404906,854603690774,3285868,-1
759,1,STEP,854603766374,854607040242,3273868,-1
760,1,STEP,854607114541,854609883015,2768474,-1
761,1,STEP,854609970314,854613272382,3302068,-1
762,1,STEP,854613345281,854616334553,2989272,-1
763,1,STEP,854616409452,854619323424,2913972,-1
764,1,STEP,854619408723,854622197696,2788973,-1
765,1,STEP,854622284795,854625084968,2800173,-1
766,1,STEP,854625174967,854628297737,3122770,-1
767,1,STEP,854628382036,854631790803,3408767,-1
768,1,STEP,854631896902,854634751075,2854173,-1
769,1,STEP,854634842074,854637216251,2374177,-1
770,1,STEP,854637298650,854640598918,3300268,-1
771,1,STEP,854640685118,854643726488,3041370,-1
772,1,STEP,854643811287,854646731159,2919872,-1
773,1,STEP,854646816258,854650374924,3558666,-1
774,1,STEP,854650467223,854653317596,2850373,-1
775,1,STEP,854653401895,854656462765,3060870,-1
776,1,STEP,854656553865,854659891332,3337467,-1
777,1,STEP,854659977232,854662861604,2884372,-1
778,1,STEP,854662949803,854666660667,3710864,-1
779,1,STEP,854666798266,854671515820,4717554,-1
780,1,STEP,854671609519,854674255994,2646475,-1
781,1,STEP,854674350393,854676711570,2361177,-1
782,1,STEP,854676798869,854679908939,3110070,-1
783,1,STEP,854679993138,854682879911,2886773,-1
784,1,STEP,854682971210,854685669084,2697874,-1
785,1,STEP,854685749583,854688816153,3066570,-1
786,1,STEP,854688901052,854691936223,3035171,-1
787,1,STEP,854692019322,854694591298,2571976,-1
788,1,STEP,854694678197,854697923765,3245568,-1
789,1,STEP,854698016065,854701115035,3098970,-1
790,1,STEP,854701199634,854704578501,3378867,-1
791,1,STEP,854704668800,854707770970,3102170,-1
792,1,STEP,854707858270,854711067139,3208869,-1
793,1,STEP,854711156838,854714296908,3140070,-1
794,1,STEP,854714382207,854717747374,3365167,-1
795,1,STEP,854717829973,854720938843,3108870,-1
796,1,STEP,854721025243,854724381910,3356667,-1
797,1,STEP,854724467409,854727144484,2677075,-1
798,1,STEP,854727226883,854730439452,3212569,-1
799,1,STEP,854730523451,854733399123,2875672,-1
800,1,STEP,854733481822,854736309495,2827673,-1
801,1,STEP,854736392194,854739760462,3368268,-1
802,1,STEP,854739846861,854742354837,2507976,-1
803,1,STEP,854742436536,854746095001,3658465,-1
804,1,STEP,854746179200,854749695466,3516266,-1
805,1,STEP,854749778665,854752448439,2669774,-1
806,1,STEP,854752533239,854755722108,3188869,-1
807,1,STEP,854755804707,854758894377,3089670,-1
808,1,STEP,854758978476,854761710550,2732074,-1
809,1,STEP,854761798549,854764716421,2917872,-1
810,1,STEP,854764802620,854767387295,2584675,-1
811,1,STEP,854767469395,854770575265,3105870,-1
812,1,STEP,854770663564,854773937132,3273568,-1
813,1,STEP,854774021731,854776978003,2956272,-1
814,1,STEP,854777067802,854779947674,2879872,-1
815,1,STEP,854780034873,854783775037,3740164,-1
816,1,STEP,854783865136,854787570801,3705665,-1
817,1,STEP,854787657000,854790948268,3291268,-1
818,1,STEP,854791034267,854794119937,3085670,-1
819,1,STEP,854794204337,854797254307,3049970,-1
820,1,STEP,854797338806,854800092180,2753374,-1
821,1,STEP,854800175279,854803184550,3009271,-1
822,1,STEP,854803267049,854806040122,2773073,-1
823,1,STEP,854806123322,854809262391,3139069,-1
824,1,STEP,854809347091,854811806467,2459376,-1
825,1,STEP,854811887766,854814623240,2735474,-1
826,1,STEP,854814705839,854817957108,3251269,-1
827,1,STEP,854818041407,854820483883,2442476,-1
828,1,STEP,854820566082,854823336456,2770374,-1
829,1,STEP,854823416555,854826321927,2905372,-1
830,1,STEP,854826407326,854829067900,2660574,-1
831,1,STEP,854829148900,854831911673,2762773,-1
832,1,STEP,854831993272,854835088542,3095270,-1
833,1,STEP,854835172441,854837770916,2598475,-1
834,1,STEP,854837851016,854840882086,3031070,-1
835,1,STEP,854840965286,854843861258,2895972,-1
836,1,STEP,854843943457,854847386524,3443067,-1
837,1,STEP,854847472823,854850431994,2959171,-1
838,1,STEP,854850513993,854853192868,2678875,-1
839,1,STEP,854853278167,854855903841,2625674,-1
840,1,STEP,854855981841,854858859813,2877972,-1
841,1,STEP,854858941412,854861843384,2901972,-1
842,1,STEP,854861935683,854865486649,3550966,-1
843,1,STEP,854865625548,854869974706,4349158,-1
844,1,STEP,854870063505,854873399273,3335768,-1
845,1,STEP,854873484172,854877224436,3740264,-1
846,1,STEP,854877314035,854880677002,3362967,-1
847,1,STEP,854880762302,854884058170,3295868,-1
848,1,STEP,854884144469,854887384038,3239569,-1
849,1,STEP,854887472937,854890974903,3501966,-1
850,1,STEP,854891066602,854893757476,2690874,-1
851,1,STEP,854893843575,854897073544,3229969,-1
852,1,STEP,854897159443,854900710409,3550966,-1
853,1,STEP,854900803008,854904059777,3256769,-1
854,1,STEP,854904158476,854906956249,2797773,-1
855,1,STEP,854907050348,854909953320,2902972,-1
856,1,STEP,854910040319,854912885092,2844773,-1
857,1,STEP,854912975891,854916069461,3093570,-1
858,1,STEP,854916153760,854919595827,3442067,-1
859,1,STEP,854919684226,854922987394,3303168,-1
860,1,STEP,854923075493,854926303962,3228469,-1
861,1,STEP,854926388662,854929535131,3146469,-1
862,1,STEP,854929618630,854933021098,3402468,-1
863,1,STEP,854933113497,854936500664,3387167,-1
864,1,STEP,854936588263,854939789932,3201669,-1
865,1,STEP,854939873431,854942950702,3077271,-1
866,1,STEP,854943034101,854945803574,2769473,-1
867,1,STEP,854945908773,854948960544,3051771,-1
868,1,STEP,854949043343,854952068914,3025571,-1
869,1,STEP,854952157613,854955585380,3427767,-1
870,1,STEP,854955669679,854958742949,3073270,-1
871,1,STEP,854958826949,854961542722,2715773,-1
872,1,STEP,854961622122,854964914690,3292568,-1
873,1,STEP,854964998589,854967951561,2952972,-1
874,1,STEP,854968033760,854970757934,2724174,-1
875,1,STEP,854970840033,854973829804,2989771,-1
876,1,STEP,854973933603,854976916174,2982571,-1
877,1,STEP,854976999373,854979798846,2799473,-1
878,1,STEP,854979881245,854983293113,3411868,-1
879,1,STEP,854983384112,854986310183,2926071,-1
880,1,STEP,854986392383,854989806450,3414067,-1
881,1,STEP,854989912449,854992651322,2738873,-1
882,1,STEP,854992738621,854995317097,2578476,-1
883,1,STEP,854995404696,854998191469,2786773,-1
884,1,STEP,854998283268,855000856643,2573375,-1
885,1,STEP,855000934442,855004272510,3338068,-1
886,1,STEP,855004355609,855007245782,2890173,-1
887,1,STEP,855007327781,855010385751,3057970,-1
888,1,STEP,855010475150,855013155425,2680275,-1
889,1,STEP,855013235324,855016536992,3301668,-1
890,1,STEP,855016622891,855019621262,2998371,-1
891,1,STEP,855019704161,855023064229,3360068,-1
892,1,STEP,855023146228,855026143799,2997571,-1
893,1,STEP,855026225898,855028579076,2353178,-1
894,1,STEP,855028657875,855031600647,2942772,-1
895,1,STEP,855031683246,855034360420,2677174,-1
896,1,STEP,855034442219,855037575289,3133070,-1
897,1,STEP,855037657088,855040824858,3167770,-1
898,1,STEP,855040913557,855043592531,2678974,-1
899,1,STEP,855043673530,855047177196,3503666,-1
900,1,STEP,855047260596,855049847471,2586875,-1
901,1,STEP,855049937670,855053024140,3086470,-1
902,1,STEP,855053105839,855056046311,2940472,-1
903,1,STEP,855056132610,855059231180,3098570,-1
904,1,STEP,855059316679,855063732337,4415658,-1
905,1,STEP,855063872335,855068178494,4306159,-1
906,1,STEP,855068257693,855071183565,2925872,-1
907,1,STEP,855071257264,855074431433,3174169,-1
908,1,STEP,855074503833,855077361405,2857572,-1
909,1,STEP,855077435404,855080170978,2735574,-1
910,1,STEP,855080252277,855083022351,2770074,-1
911,1,STEP,855083099050,855086625416,3526366,-1
912,1,STEP,855086709915,855089222691,2512776,-1
913,1,STEP,855089296190,855092431660,3135470,-1
914,1,STEP,855092506359,855095658629,3152270,-1
915,1,STEP,855095736128,855098890997,3154869,-1
916,1,STEP,855098972097,855101590971,2618874,-1
917,1,STEP,855101664071,855104194146,2530075,-1
918,1,STEP,855104272346,855107286316,3013970,-1
919,1,STEP,855107360616,855110673184,3312568,-1
920,1,STEP,855110757883,855114038951,3281068,-1
921,1,STEP,855114117951,855117542118,3424167,-1
922,1,STEP,855117623317,855120385590,2762273,-1
923,1,STEP,855120459989,855123810057,3350068,-1
924,1,STEP,855123894256,855126526031,2631775,-1
925,1,STEP,855126600030,855129965698,3365668,-1
926,1,STEP,855130051197,855133181267,3130070,-1
927,1,STEP,855133259966,855135907540,2647574,-1
928,1,STEP,855135984340,855138713713,2729373,-1
929,1,STEP,855138788413,855141919582,3131169,-1
930,1,STEP,855141996182,855144883454,2887272,-1
931,1,STEP,855144961453,855147690927,2729474,-1
932,1,STEP,855147769426,855151257692,3488266,-1
933,1,STEP,855151336992,855154556660,3219668,-1
934,1,STEP,855154634960,855157927628,3292668,-1
935,1,STEP,855158014127,855161584893,3570766,-1
936,1,STEP,855161656992,855165110859,3453867,-1
937,1,STEP,855165192258,855168078230,2885972,-1
938,1,STEP,855168150829,855172154791,4003962,-1
939,1,STEP,855172299389,855174943864,2644475,-1
940,1,STEP,855175017963,855178091333,3073370,-1
941,1,STEP,855178165533,855180989905,2824372,-1
942,1,STEP,855181060505,855183804478,2743973,-1
943,1,STEP,855183875478,855186692750,2817272,-1
944,1,STEP,855186763750,855189777021,3013271,-1
945,1,STEP,855189848620,855193121988,3273368,-1
946,1,STEP,855193195288,855196653654,3458366,-1
947,1,STEP,855196728754,855199753324,3024570,-1
948,1,STEP,855199825624,855202130302,2304678,-1
949,1,STEP,855202199901,855205819966,3620065,-1
950,1,STEP,855205917965,855209240333,3322368,-1
951,1,STEP,855209312232,855212288804,2976572,-1
952,1,STEP,855212359903,855215741370,3381467,-1
953,1,STEP,855215816069,855218185247,2369178,-1
954,1,STEP,855218256246,855221464015,3207769,-1
955,1,STEP,855221536614,855224404687,2868073,-1
956,1,STEP,855224476686,855228081351,3604665,-1
957,1,STEP,855228154050,855231243621,3089571,-1
958,1,STEP,855231315820,855234292091,2976271,-1
959,1,STEP,855234364291,855237211963,2847672,-1
960,1,STEP,855237283262,855240366733,3083471,-1
961,1,STEP,855240439332,855243842999,3403667,-1
962,1,STEP,855243917898,855247155767,3237869,-1
963,1,STEP,855247229866,855250160038,2930172,-1
964,1,STEP,855250234337,855253314808,3080471,-1
965,1,STEP,855253421607,855256951773,3530166,-1
966,1,STEP,855257063772,855260209641,3145869,-1
967,1,STEP,855260324840,855263168713,2843873,-1
968,1,STEP,855263283212,855266358482,3075270,-1
969,1,STEP,855266468581,855269018756,2550175,-1
970,1,STEP,855269130255,855271852829,2722574,-1
971,1,STEP,855271966628,855274931599,2964971,-1
972,1,STEP,855275043598,855278122968,3079370,-1
973,1,STEP,855278229367,855281109540,2880173,-1
974,1,STEP,855281219639,855284249809,3030170,-1
975,1,STEP,855284362708,855287416379,3053671,-1
976,1,STEP,855287530778,855290755847,3225069,-1
977,1,STEP,855290872345,855293545520,2673175,-1
978,1,STEP,855293656519,855296863588,3207069,-1
979,1,STEP,855296979687,855300135556,3155869,-1
980,1,STEP,855300250455,855303427324,3176869,-1
981,1,STEP,855303536623,855306332396,2795773,-1
982,1,STEP,855306440195,855309525666,3085471,-1
983,1,STEP,855309636064,855312812834,3176770,-1
984,1,STEP,855312925833,855315749405,2823572,-1
985,1,STEP,855315856904,855318749877,2892973,-1
986,1,STEP,855318858275,855321492250,2633975,-1
987,1,STEP,855321601849,855324852118,3250269,-1
988,1,STEP,855324964917,855328050887,3085970,-1
989,1,STEP,855328159886,855331105157,2945271,-1
990,1,STEP,855331220656,855333738932,2518276,-1
991,1,STEP,855333850031,855336867902,3017871,-1
992,1,STEP,855336980701,855339907972,2927271,-1
993,1,STEP,855340015771,855342954843,2939072,-1
994,1,STEP,855343067042,855345954414,2887372,-1
995,1,STEP,855346076613,855349585579,3508966,-1
996,1,STEP,855349699878,855352618250,2918372,-1
997,1,STEP,855352734349,855355849819,3115470,-1
998,1,STEP,855355964118,855359008388,3044270,-1
999,1,STEP,855359123787,855362255157,3131370,-1
