Gen,Resource,Stamp,TimeStamp_Start,TimeStamp_End,Duration,Indiv_id
0,1,FirstEvaluation,827516661321,828400087919,883426598,-1
0,1,STEP,828400239118,828407762644,7523526,-1
1,1,STEP,828407871343,828413456489,5585146,-1
2,1,STEP,828413553688,828420980015,7426327,-1
3,1,STEP,828421111714,828427335053,6223339,-1
4,1,STEP,828427414052,828431479513,4065461,-1
5,1,STEP,828431587811,828438358145,6770334,-1
6,1,STEP,828438495744,828443807092,5311348,-1
7,1,STEP,828443879891,828449668835,5788944,-1
8,1,STEP,828449832833,828455390979,5558146,-1
9,1,STEP,828455545977,828462989604,7443627,-1
10,1,STEP,828463114903,828468747848,5632945,-1
11,1,STEP,828468886447,828475575981,6689534,-1
12,1,STEP,828475706380,828483355205,7648825,-1
13,1,STEP,828483528204,828489928441,6400237,-1
14,1,STEP,828490051840,828496492377,6440537,-1
15,1,STEP,828496619776,828501592027,4972251,-1
16,1,STEP,828501724026,828506459679,4735653,-1
17,1,STEP,828506594478,828512583519,5989041,-1
18,1,STEP,828512655019,828517906867,5251848,-1
19,1,STEP,828518044766,828523081617,5036851,-1
20,1,STEP,828523217915,828529950350,6732435,-1
21,1,STEP,828530080148,828535721993,5641845,-1
22,1,STEP,828535851092,828540719344,4868252,-1
23,1,STEP,828540845443,828546326190,5480747,-1
24,1,STEP,828546461088,828551820536,5359448,-1
25,1,STEP,828551902735,828556215893,4313158,-1
26,1,STEP,828556289092,828561652840,5363748,-1
27,1,STEP,828561798638,828567820679,6022041,-1
28,1,STEP,828567909478,828572218036,4308558,-1
29,1,STEP,828572312435,828578172878,5860443,-1
30,1,STEP,828578278077,828582871432,4593355,-1
31,1,STEP,828582999131,828588656576,5657445,-1
32,1,STEP,828588745975,828593077432,4331457,-1
33,1,STEP,828593164632,828597190492,4025860,-1
34,1,STEP,828597299791,828601530750,4230959,-1
35,1,STEP,828601610849,828604944916,3334067,-1
36,1,STEP,828605022716,828608501582,3478866,-1
37,1,STEP,828608580081,828611630051,3049970,-1
38,1,STEP,828611706550,828614501923,2795373,-1
39,1,STEP,828614578222,828617587793,3009571,-1
40,1,STEP,828617661692,828621021359,3359667,-1
41,1,STEP,828621099558,828624384826,3285268,-1
42,1,STEP,828624462626,828628235189,3772563,-1
43,1,STEP,828628313288,828631672655,3359367,-1
44,1,STEP,828631787354,828636543307,4755953,-1
45,1,STEP,828636638006,828641125563,4487557,-1
46,1,STEP,828641221562,828645257222,4035660,-1
47,1,STEP,828645361021,828648575290,3214269,-1
48,1,STEP,828648666889,828652953247,4286358,-1
49,1,STEP,828653082446,828656567512,3485066,-1
50,1,STEP,828656646311,828660280375,3634064,-1
51,1,STEP,828660353975,828664556133,4202158,-1
52,1,STEP,828664632533,828668176598,3544065,-1
53,1,STEP,828668246397,828672103360,3856963,-1
54,1,STEP,828672220459,828675827123,3606664,-1
55,1,STEP,828675936122,828680315179,4379057,-1
56,1,STEP,828680429678,828684267641,3837963,-1
57,1,STEP,828684383240,828687305811,2922571,-1
58,1,STEP,828687413110,828690531779,3118669,-1
59,1,STEP,828690644778,828693450251,2805473,-1
60,1,STEP,828693563850,828696790318,3226468,-1
61,1,STEP,828696902917,828700777279,3874362,-1
62,1,STEP,828700863478,828703954748,3091270,-1
63,1,STEP,828704026348,828707736611,3710263,-1
64,1,STEP,828707827710,828712206568,4378858,-1
65,1,STEP,828712324266,828717298618,4974352,-1
66,1,STEP,828717423217,828720491787,3068570,-1
67,1,STEP,828720585886,828724114451,3528565,-1
68,1,STEP,828724194950,828728174911,3979961,-1
69,1,STEP,828728256511,828731139682,2883171,-1
70,1,STEP,828731246981,828734739447,3492466,-1
71,1,STEP,828734873746,828739720099,4846353,-1
72,1,STEP,828739861197,828745114346,5253149,-1
73,1,STEP,828745258744,828749019908,3761164,-1
74,1,STEP,828749094907,828752202676,3107769,-1
75,1,STEP,828752287376,828755430845,3143469,-1
76,1,STEP,828755525444,828758374416,2848972,-1
77,1,STEP,828758507815,828761958981,3451166,-1
78,1,STEP,828762061180,828765476947,3415767,-1
79,1,STEP,828765567946,828768953113,3385167,-1
80,1,STEP,828769074611,828772924874,3850263,-1
81,1,STEP,828773043873,828776483539,3439666,-1
82,1,STEP,828776600338,828780494200,3893862,-1
83,1,STEP,828780608499,828784264163,3655664,-1
84,1,STEP,828784372862,828788609220,4236358,-1
85,1,STEP,828788761019,828793512673,4751654,-1
86,1,STEP,828793653271,828798087228,4433957,-1
87,1,STEP,828798208027,828801622493,3414466,-1
88,1,STEP,828801740692,828805099159,3358467,-1
89,1,STEP,828805232158,828809150120,3917962,-1
90,1,STEP,828809274318,828814424268,5149950,-1
91,1,STEP,828814574567,828820111712,5537145,-1
92,1,STEP,828820250711,828826710548,6459837,-1
93,1,STEP,828826868146,828831352603,4484457,-1
94,1,STEP,828831501201,828836161056,4659855,-1
95,1,STEP,828836301954,828841539303,5237349,-1
96,1,STEP,828841666902,828847121748,5454846,-1
97,1,STEP,828847253347,828851944201,4690854,-1
98,1,STEP,828852081900,828856685355,4603455,-1
99,1,STEP,828858539437,828863615187,5075750,-1
100,1,STEP,828863771086,828868021444,4250358,-1
101,1,STEP,828869363231,828873627789,4264558,-1
102,1,STEP,828873730988,828877505851,3774863,-1
103,1,STEP,828877627950,828881732810,4104860,-1
104,1,STEP,828881854909,828885837770,3982861,-1
105,1,STEP,828886377764,828891089118,4711354,-1
106,1,STEP,828891226817,828895144179,3917362,-1
107,1,STEP,828895263278,828898862042,3598764,-1
108,1,STEP,828898950542,828902488807,3538265,-1
109,1,STEP,828902590006,828905702776,3112770,-1
110,1,STEP,828905797775,828909972434,4174659,-1
111,1,STEP,828910105732,828914433090,4327358,-1
112,1,STEP,828914572189,828919120944,4548755,-1
113,1,STEP,828919240943,828923494102,4253159,-1
114,1,STEP,828923641300,828928710951,5069651,-1
115,1,STEP,828928840149,828932610212,3770063,-1
116,1,STEP,828932750711,828942032520,9281809,-1
117,1,STEP,828942185819,828947483167,5297348,-1
118,1,STEP,828947629366,828954420599,6791233,-1
119,1,STEP,828954570798,828960180643,5609845,-1
120,1,STEP,828960310442,828966018186,5707744,-1
121,1,STEP,828966160884,828972605721,6444837,-1
122,1,STEP,828972758320,828977770771,5012451,-1
123,1,STEP,828977928469,828982825421,4896952,-1
124,1,STEP,828982966220,828988274368,5308148,-1
125,1,STEP,828988411567,828993438318,5026751,-1
126,1,STEP,828993522917,828997998773,4475856,-1
127,1,STEP,828998141472,829003664818,5523346,-1
128,1,STEP,829003849416,829008881167,5031751,-1
129,1,STEP,829009028565,829013103825,4075260,-1
130,1,STEP,829013244324,829017172686,3928362,-1
131,1,STEP,829017474583,829022264836,4790253,-1
132,1,STEP,829022395734,829027405086,5009352,-1
133,1,STEP,829027669883,829032250738,4580855,-1
134,1,STEP,829038240580,829051814447,13573867,-1
135,1,STEP,829051947546,829056233804,4286258,-1
136,1,STEP,829056360602,829060817059,4456457,-1
137,1,STEP,829060912858,829065886009,4973151,-1
138,1,STEP,829066024908,829070621463,4596555,-1
139,1,STEP,829070742862,829075536015,4793153,-1
140,1,STEP,829075671514,829080610765,4939251,-1
141,1,STEP,829080767664,829085744515,4976851,-1
142,1,STEP,829085930613,829091398660,5468047,-1
143,1,STEP,829091487359,829095158223,3670864,-1
144,1,STEP,829095255422,829098605589,3350167,-1
145,1,STEP,829098740688,829104703830,5963142,-1
146,1,STEP,829104796929,829107598301,2801372,-1
147,1,STEP,829107683301,829110470273,2786972,-1
148,1,STEP,829110578172,829114245536,3667364,-1
149,1,STEP,829114340735,829117701803,3361068,-1
150,1,STEP,829117797802,829121516565,3718763,-1
151,1,STEP,829121606864,829125145130,3538266,-1
152,1,STEP,829125227229,829129003692,3776463,-1
153,1,STEP,829129135591,829133454249,4318658,-1
154,1,STEP,829133598347,829137193412,3595065,-1
155,1,STEP,829137331111,829142540160,5209049,-1
156,1,STEP,829142680258,829146477721,3797463,-1
157,1,STEP,829146735219,829151672870,4937651,-1
158,1,STEP,829151943168,829157685112,5741944,-1
159,1,STEP,829157816210,829161773072,3956862,-1
160,1,STEP,829161886771,829167690514,5803743,-1
161,1,STEP,829167962311,829172278069,4315758,-1
162,1,STEP,829172409468,829176749325,4339857,-1
163,1,STEP,829176823824,829179643197,2819373,-1
164,1,STEP,829179714096,829182934765,3220669,-1
165,1,STEP,829183042864,829186272432,3229568,-1
166,1,STEP,829186364431,829189371602,3007171,-1
167,1,STEP,829189464001,829192529771,3065770,-1
168,1,STEP,829192621870,829196237335,3615465,-1
169,1,STEP,829196334134,829199924199,3590065,-1
170,1,STEP,829200047097,829203962359,3915262,-1
171,1,STEP,829204084358,829207853421,3769063,-1
172,1,STEP,829207948620,829210975591,3026971,-1
173,1,STEP,829211274788,829215746044,4471256,-1
174,1,STEP,829215896942,829221209190,5312248,-1
175,1,STEP,829221346589,829225722346,4375757,-1
176,1,STEP,829225841645,829230641598,4799953,-1
177,1,STEP,829230734097,829234355462,3621365,-1
178,1,STEP,829234632559,829238151325,3518766,-1
179,1,STEP,829238244724,829242934878,4690154,-1
180,1,STEP,829243083177,829246364845,3281668,-1
181,1,STEP,829246447544,829250009909,3562365,-1
182,1,STEP,829250136108,829253866371,3730263,-1
183,1,STEP,829253989770,829257933131,3943361,-1
184,1,STEP,829258049530,829261755194,3705664,-1
185,1,STEP,829261865393,829265202560,3337167,-1
186,1,STEP,829265316659,829267940334,2623675,-1
187,1,STEP,829268051232,829271090103,3038871,-1
188,1,STEP,829271202702,829274256272,3053570,-1
189,1,STEP,829274370271,829276998945,2628674,-1
190,1,STEP,829277108144,829279931616,2823472,-1
191,1,STEP,829280044615,829283285183,3240568,-1
192,1,STEP,829283396582,829286494252,3097670,-1
193,1,STEP,829286617151,829289733220,3116069,-1
194,1,STEP,829289815720,829293660482,3844762,-1
195,1,STEP,829293781081,829297450245,3669164,-1
196,1,STEP,829297574944,829302912592,5337648,-1
197,1,STEP,829303038490,829307310549,4272059,-1
198,1,STEP,829307447647,829311418608,3970961,-1
199,1,STEP,829311784105,829316138662,4354557,-1
200,1,STEP,829316237161,829320335621,4098460,-1
201,1,STEP,829320424520,829323614489,3189969,-1
202,1,STEP,829323755388,829327694149,3938761,-1
203,1,STEP,829327814548,829331943008,4128460,-1
204,1,STEP,829332080606,829336693661,4613055,-1
205,1,STEP,829336822360,829341592113,4769753,-1
206,1,STEP,829341696712,829346669864,4973152,-1
207,1,STEP,829346802962,829350623825,3820863,-1
208,1,STEP,829350741724,829354266989,3525265,-1
209,1,STEP,829354407688,829359151442,4743754,-1
210,1,STEP,829359236041,829362055513,2819472,-1
211,1,STEP,829362144212,829365643078,3498866,-1
212,1,STEP,829365778177,829369492841,3714664,-1
213,1,STEP,829369614939,829373993997,4379058,-1
214,1,STEP,829374126695,829378689151,4562456,-1
215,1,STEP,829378777250,829382322015,3544765,-1
216,1,STEP,829382465214,829388044759,5579545,-1
217,1,STEP,829388177158,829391703723,3526565,-1
218,1,STEP,829391788423,829397328668,5540245,-1
219,1,STEP,829397457867,829401196031,3738164,-1
220,1,STEP,829401313029,829405682587,4369558,-1
221,1,STEP,829405775186,829409024754,3249568,-1
222,1,STEP,829409155953,829413262613,4106660,-1
223,1,STEP,829413371911,829416980776,3608865,-1
224,1,STEP,829417078775,829420310544,3231769,-1
225,1,STEP,829420406743,829423587512,3180769,-1
226,1,STEP,829423682311,829426707681,3025370,-1
227,1,STEP,829426803580,829429813651,3010071,-1
228,1,STEP,829429920750,829432684023,2763273,-1
229,1,STEP,829432776422,829435758393,2981971,-1
230,1,STEP,829435852792,829439380757,3527965,-1
231,1,STEP,829439475556,829442600426,3124870,-1
232,1,STEP,829442718825,829445379799,2660974,-1
233,1,STEP,829445458498,829449297560,3839062,-1
234,1,STEP,829449404859,829452577828,3172969,-1
235,1,STEP,829452693227,829457200183,4506956,-1
236,1,STEP,829457334382,829461603640,4269258,-1
237,1,STEP,829461736839,829467148886,5412047,-1
238,1,STEP,829467294084,829471681141,4387057,-1
239,1,STEP,829471821240,829476990289,5169049,-1
240,1,STEP,829477137688,829482425136,5287448,-1
241,1,STEP,829482564335,829487717285,5152950,-1
242,1,STEP,829487853583,829492646136,4792553,-1
243,1,STEP,829492787035,829498086083,5299048,-1
244,1,STEP,829498220582,829504048025,5827443,-1
245,1,STEP,829504167724,829509769569,5601845,-1
246,1,STEP,829509950667,829513531332,3580665,-1
247,1,STEP,829513653631,829517376795,3723164,-1
248,1,STEP,829517496493,829521491354,3994861,-1
249,1,STEP,829521603153,829526643504,5040351,-1
250,1,STEP,829526786403,829531397557,4611154,-1
251,1,STEP,829531492357,829535485817,3993460,-1
252,1,STEP,829535621116,829539693876,4072760,-1
253,1,STEP,829539822575,829544070534,4247959,-1
254,1,STEP,829544155333,829548657989,4502656,-1
255,1,STEP,829548743388,829552065955,3322567,-1
256,1,STEP,829552248154,829555456622,3208468,-1
257,1,STEP,829555541321,829560346774,4805453,-1
258,1,STEP,829560432874,829563255146,2822272,-1
259,1,STEP,829563387345,829566933710,3546365,-1
260,1,STEP,829567072109,829570966771,3894662,-1
261,1,STEP,829571104669,829574403237,3298568,-1
262,1,STEP,829574532436,829577962402,3429966,-1
263,1,STEP,829578085201,829583857644,5772443,-1
264,1,STEP,829583991443,829588080203,4088760,-1
265,1,STEP,829588172402,829591015474,2843072,-1
266,1,STEP,829591100374,829595729128,4628754,-1
267,1,STEP,829595815028,829600828579,5013551,-1
268,1,STEP,829600913678,829604154546,3240868,-1
269,1,STEP,829604241245,829607342315,3101070,-1
270,1,STEP,829607465014,829611626173,4161159,-1
271,1,STEP,829611756572,829615677633,3921061,-1
272,1,STEP,829615776032,829619394397,3618365,-1
273,1,STEP,829619489296,829622382468,2893172,-1
274,1,STEP,829622508667,829625127541,2618874,-1
275,1,STEP,829625209740,829628732906,3523166,-1
276,1,STEP,829628834605,829632424170,3589565,-1
277,1,STEP,829632518269,829635729937,3211668,-1
278,1,STEP,829635845836,829638873207,3027371,-1
279,1,STEP,829638955906,829642249774,3293868,-1
280,1,STEP,829642368372,829645711240,3342868,-1
281,1,STEP,829645816339,829649085207,3268868,-1
282,1,STEP,829649181606,829652589672,3408066,-1
283,1,STEP,829652711271,829655652742,2941471,-1
284,1,STEP,829655768641,829658926610,3157969,-1
285,1,STEP,829659043509,829662257578,3214069,-1
286,1,STEP,829662372677,829665547646,3174969,-1
287,1,STEP,829665660145,829668611016,2950871,-1
288,1,STEP,829668725515,829671845384,3119869,-1
289,1,STEP,829671959283,829674416759,2457476,-1
290,1,STEP,829674531058,829677347030,2815972,-1
291,1,STEP,829677462229,829680219302,2757073,-1
292,1,STEP,829680335601,829683571169,3235568,-1
293,1,STEP,829683691968,829686743338,3051370,-1
294,1,STEP,829686858937,829689989907,3130970,-1
295,1,STEP,829690122005,829693981068,3859063,-1
296,1,STEP,829694074867,829697252736,3177869,-1
297,1,STEP,829697389134,829700563803,3174669,-1
298,1,STEP,829700661002,829703891971,3230969,-1
299,1,STEP,829703986170,829706817742,2831572,-1
300,1,STEP,829706909341,829710553106,3643765,-1
301,1,STEP,829710691904,829713765374,3073470,-1
302,1,STEP,829713907473,829717329539,3422066,-1
303,1,STEP,829717416939,829721434499,4017560,-1
304,1,STEP,829721548798,829724841966,3293168,-1
305,1,STEP,829724944165,829728979625,4035460,-1
306,1,STEP,829729077624,829733150185,4072561,-1
307,1,STEP,829733247884,829736420153,3172269,-1
308,1,STEP,829736508052,829740483513,3975461,-1
309,1,STEP,829740570112,829743908579,3338467,-1
310,1,STEP,829744046578,829747629543,3582965,-1
311,1,STEP,829747768242,829751128409,3360167,-1
312,1,STEP,829751246608,829754617075,3370467,-1
313,1,STEP,829754722474,829759018432,4295958,-1
314,1,STEP,829759133931,829763099392,3965461,-1
315,1,STEP,829763230891,829766771456,3540565,-1
316,1,STEP,829766897155,829770251622,3354467,-1
317,1,STEP,829770353521,829774543880,4190359,-1
318,1,STEP,829774670679,829779859128,5188449,-1
319,1,STEP,829779993627,829785163776,5170149,-1
320,1,STEP,829785318875,829790449824,5130949,-1
321,1,STEP,829790585123,829796028570,5443447,-1
322,1,STEP,829796166169,829801188919,5022750,-1
323,1,STEP,829801327918,829807906754,6578836,-1
324,1,STEP,829808027753,829811704617,3676864,-1
325,1,STEP,829811849915,829817012065,5162150,-1
326,1,STEP,829817142363,829822460911,5318548,-1
327,1,STEP,829822595010,829826445472,3850462,-1
328,1,STEP,829826539272,829829599442,3060170,-1
329,1,STEP,829829733840,829832897909,3164069,-1
330,1,STEP,829833012208,829836271676,3259468,-1
331,1,STEP,829836385575,829839866141,3480566,-1
332,1,STEP,829839962840,829842656214,2693374,-1
333,1,STEP,829842765613,829847229369,4463756,-1
334,1,STEP,829847328668,829851380029,4051361,-1
335,1,STEP,829851483228,829857984364,6501136,-1
336,1,STEP,829858092763,829861430630,3337867,-1
337,1,STEP,829861553829,829864961396,3407567,-1
338,1,STEP,829865088795,829869056656,3967861,-1
339,1,STEP,829869190454,829872415723,3225269,-1
340,1,STEP,829872525022,829876550582,4025560,-1
341,1,STEP,829876662581,829881452835,4790254,-1
342,1,STEP,829881588333,829886901481,5313148,-1
343,1,STEP,829887005480,829890617145,3611665,-1
344,1,STEP,829890708044,829895431598,4723554,-1
345,1,STEP,829895561697,829899227761,3666064,-1
346,1,STEP,829899321160,829903052723,3731563,-1
347,1,STEP,829903186422,829906537489,3351067,-1
348,1,STEP,829906628088,829910266253,3638165,-1
349,1,STEP,829910371252,829914031916,3660664,-1
350,1,STEP,829914129015,829917352984,3223969,-1
351,1,STEP,829917440983,829921117347,3676364,-1
352,1,STEP,829921201546,829925741902,4540356,-1
353,1,STEP,829925895600,829930347256,4451656,-1
354,1,STEP,829930478255,829935032911,4554656,-1
355,1,STEP,829935167809,829941039452,5871643,-1
356,1,STEP,829941182751,829946047803,4865052,-1
357,1,STEP,829946196401,829951018054,4821653,-1
358,1,STEP,829951149653,829955768808,4619155,-1
359,1,STEP,829955901407,829960755459,4854052,-1
360,1,STEP,829960885258,829966426304,5541046,-1
361,1,STEP,829966570002,829971293556,4723554,-1
362,1,STEP,829971395555,829975551814,4156259,-1
363,1,STEP,829975707713,829979690574,3982861,-1
364,1,STEP,829979832773,829983548636,3715863,-1
365,1,STEP,829983644835,829986981403,3336568,-1
366,1,STEP,829987065002,829991268561,4203559,-1
367,1,STEP,829991373060,829995880516,4507456,-1
368,1,STEP,829996021714,830000123274,4101560,-1
369,1,STEP,830000261973,830004611630,4349657,-1
370,1,STEP,830004743129,830007871398,3128269,-1
371,1,STEP,830007968897,830011919459,3950562,-1
372,1,STEP,830012019258,830015602923,3583665,-1
373,1,STEP,830015707222,830019823282,4116060,-1
374,1,STEP,830019923781,830022996051,3072270,-1
375,1,STEP,830023095750,830026574816,3479066,-1
376,1,STEP,830026683114,830029790284,3107170,-1
377,1,STEP,830029947383,830033824045,3876662,-1
378,1,STEP,830033984643,830038311801,4327158,-1
379,1,STEP,830038436400,830043120654,4684254,-1
380,1,STEP,830043276352,830048021006,4744654,-1
381,1,STEP,830048161704,830051690270,3528566,-1
382,1,STEP,830051768869,830055598232,3829363,-1
383,1,STEP,830055697131,830059185797,3488666,-1
384,1,STEP,830059305995,830062717562,3411567,-1
385,1,STEP,830062846761,830066165228,3318467,-1
386,1,STEP,830066293327,830070642185,4348858,-1
387,1,STEP,830070789283,830075478637,4689354,-1
388,1,STEP,830075607736,830080231591,4623855,-1
389,1,STEP,830080361890,830083204862,2842972,-1
390,1,STEP,830083317761,830086513329,3195568,-1
391,1,STEP,830086634728,830089723598,3088870,-1
392,1,STEP,830089835197,830093155765,3320568,-1
393,1,STEP,830093266463,830097425623,4159160,-1
394,1,STEP,830097550822,830101110487,3559665,-1
395,1,STEP,830101199786,830106189237,4989451,-1
396,1,STEP,830106325836,830111107389,4781553,-1
397,1,STEP,830111235488,830115591645,4356157,-1
398,1,STEP,830115728244,830120482197,4753953,-1
399,1,STEP,830120608096,830125715946,5107850,-1
400,1,STEP,830125847045,830130220002,4372957,-1
401,1,STEP,830130355201,830133667568,3312367,-1
402,1,STEP,830133740368,830136104345,2363977,-1
403,1,STEP,830136175544,830139313513,3137969,-1
404,1,STEP,830139401712,830142271784,2870072,-1
405,1,STEP,830142399383,830145520552,3121169,-1
406,1,STEP,830145593752,830148798520,3204768,-1
407,1,STEP,830148875020,830152096188,3221168,-1
408,1,STEP,830152170987,830155445155,3274168,-1
409,1,STEP,830155523755,830158867022,3343267,-1
410,1,STEP,830158941921,830161793493,2851572,-1
411,1,STEP,830161865793,830165115661,3249868,-1
412,1,STEP,830165189660,830167908334,2718674,-1
413,1,STEP,830167981433,830171542598,3561165,-1
414,1,STEP,830171617697,830174474869,2857172,-1
415,1,STEP,830174547169,830176902646,2355477,-1
416,1,STEP,830176973545,830180043515,3069970,-1
417,1,STEP,830180116614,830182732989,2616375,-1
418,1,STEP,830182833088,830185781459,2948371,-1
419,1,STEP,830185852158,830188832629,2980471,-1
420,1,STEP,830188905528,830193126887,4221359,-1
421,1,STEP,830193265986,830197773142,4507156,-1
422,1,STEP,830197919840,830202289897,4370057,-1
423,1,STEP,830202365997,830205494166,3128169,-1
424,1,STEP,830205567665,830208362238,2794573,-1
425,1,STEP,830208435137,830211445408,3010271,-1
426,1,STEP,830211525507,830214838875,3313368,-1
427,1,STEP,830214932874,830217487749,2554875,-1
428,1,STEP,830217558548,830221118113,3559565,-1
429,1,STEP,830221192113,830224314882,3122769,-1
430,1,STEP,830224395581,830227230154,2834573,-1
431,1,STEP,830227341052,830230396823,3055771,-1
432,1,STEP,830230509921,830233216995,2707074,-1
433,1,STEP,830233319294,830236933359,3614065,-1
434,1,STEP,830237048558,830239739631,2691073,-1
435,1,STEP,830239853230,830243172998,3319768,-1
436,1,STEP,830243289196,830246107269,2818073,-1
437,1,STEP,830246214668,830249334837,3120169,-1
438,1,STEP,830249444036,830252914102,3470066,-1
439,1,STEP,830253029901,830257075862,4045961,-1
440,1,STEP,830257166061,830260421229,3255168,-1
441,1,STEP,830260496728,830263092203,2595475,-1
442,1,STEP,830263166002,830266393371,3227369,-1
443,1,STEP,830266466570,830270165034,3698464,-1
444,1,STEP,830270240233,830273460901,3220668,-1
445,1,STEP,830273535101,830276080876,2545775,-1
446,1,STEP,830276153375,830279484043,3330668,-1
447,1,STEP,830279556842,830282304315,2747473,-1
448,1,STEP,830282374314,830285183787,2809473,-1
449,1,STEP,830285254986,830288045559,2790573,-1
450,1,STEP,830288117658,830290858931,2741273,-1
451,1,STEP,830290931331,830293904302,2972971,-1
452,1,STEP,830293977201,830297061671,3084470,-1
453,1,STEP,830297133170,830300145141,3011971,-1
454,1,STEP,830300218340,830303457008,3238668,-1
455,1,STEP,830303579407,830306819575,3240168,-1
456,1,STEP,830306894475,830309856446,2961971,-1
457,1,STEP,830309940045,830313027115,3087070,-1
458,1,STEP,830313101514,830316116684,3015170,-1
459,1,STEP,830316190884,830319451152,3260268,-1
460,1,STEP,830319524751,830322649321,3124570,-1
461,1,STEP,830322725020,830325802290,3077270,-1
462,1,STEP,830325885989,830328836160,2950171,-1
463,1,STEP,830328909359,830332142428,3233069,-1
464,1,STEP,830332214227,830335449995,3235768,-1
465,1,STEP,830335523295,830339137259,3613964,-1
466,1,STEP,830339213559,830342871123,3657564,-1
467,1,STEP,830342962222,830346643186,3680964,-1
468,1,STEP,830346729385,830350313650,3584265,-1
469,1,STEP,830350401949,830353769816,3367867,-1
470,1,STEP,830353853415,830357445180,3591765,-1
471,1,STEP,830357529379,830360473951,2944572,-1
472,1,STEP,830360556950,830364662310,4105360,-1
473,1,STEP,830364748809,830368164575,3415766,-1
474,1,STEP,830368238275,830372173436,3935161,-1
475,1,STEP,830372262335,830375102308,2839973,-1
476,1,STEP,830375201007,830378235377,3034370,-1
477,1,STEP,830378321576,830381474845,3153269,-1
478,1,STEP,830381558044,830385250608,3692564,-1
479,1,STEP,830385336708,830388350478,3013770,-1
480,1,STEP,830388437177,830391306349,2869172,-1
481,1,STEP,830391394148,830394423619,3029471,-1
482,1,STEP,830394509318,830396947994,2438676,-1
483,1,STEP,830397028193,830399949465,2921272,-1
484,1,STEP,830400073763,830403518030,3444267,-1
485,1,STEP,830403610929,830407049295,3438366,-1
486,1,STEP,830407138394,830409968667,2830273,-1
487,1,STEP,830410058666,830412874338,2815672,-1
488,1,STEP,830412960937,830416389804,3428867,-1
489,1,STEP,830416482603,830419701872,3219269,-1
490,1,STEP,830419792371,830422685742,2893371,-1
491,1,STEP,830422770542,830425653613,2883071,-1
492,1,STEP,830425747812,830429507076,3759264,-1
493,1,STEP,830429603675,830432272049,2668374,-1
494,1,STEP,830432392647,830435223920,2831273,-1
495,1,STEP,830435328719,830438147291,2818572,-1
496,1,STEP,830438234190,830441119662,2885472,-1
497,1,STEP,830441248461,830444304331,3055870,-1
498,1,STEP,830444417030,830448460890,4043860,-1
499,1,STEP,830448578989,830451744158,3165169,-1
500,1,STEP,830451858057,830455210224,3352167,-1
501,1,STEP,830455331723,830458156896,2825173,-1
502,1,STEP,830458265694,830461273565,3007871,-1
503,1,STEP,830461391964,830464734931,3342967,-1
504,1,STEP,830464854430,830467938300,3083870,-1
505,1,STEP,830468039799,830470967070,2927271,-1
506,1,STEP,830471068369,830473812342,2743973,-1
507,1,STEP,830473925841,830477074011,3148170,-1
508,1,STEP,830477160210,830480554177,3393967,-1
509,1,STEP,830480676175,830483849844,3173669,-1
510,1,STEP,830483939943,830486867815,2927872,-1
511,1,STEP,830486961314,830490083183,3121869,-1
512,1,STEP,830490268582,830493321352,3052770,-1
513,1,STEP,830493395951,830496138124,2742173,-1
514,1,STEP,830496210923,830499270893,3059970,-1
515,1,STEP,830499343993,830502151265,2807272,-1
516,1,STEP,830502225365,830505454133,3228768,-1
517,1,STEP,830505546332,830508549103,3002771,-1
518,1,STEP,830508622602,830511989369,3366767,-1
519,1,STEP,830512064668,830515202238,3137570,-1
520,1,STEP,830515275437,830518676704,3401267,-1
521,1,STEP,830518751903,830522041571,3289668,-1
522,1,STEP,830522116870,830525371138,3254268,-1
523,1,STEP,830525445938,830528727705,3281767,-1
524,1,STEP,830528801105,830532088473,3287368,-1
525,1,STEP,830532165172,830535621638,3456466,-1
526,1,STEP,830535696737,830538873406,3176669,-1
527,1,STEP,830538949006,830541799578,2850572,-1
528,1,STEP,830541880977,830544620650,2739673,-1
529,1,STEP,830544690549,830548004217,3313668,-1
530,1,STEP,830548082616,830551269885,3187269,-1
531,1,STEP,830551347284,830554702151,3354867,-1
532,1,STEP,830554779851,830557559324,2779473,-1
533,1,STEP,830557631123,830560877391,3246268,-1
534,1,STEP,830560952990,830563767763,2814773,-1
535,1,STEP,830563843762,830567004331,3160569,-1
536,1,STEP,830567081330,830569962502,2881172,-1
537,1,STEP,830570039502,830572710175,2670673,-1
538,1,STEP,830572782575,830576874235,4091660,-1
539,1,STEP,830576951234,830579523309,2572075,-1
540,1,STEP,830579594708,830582527679,2932971,-1
541,1,STEP,830582601179,830585982046,3380867,-1
542,1,STEP,830586053745,830588288523,2234778,-1
543,1,STEP,830588359122,830591408293,3049171,-1
544,1,STEP,830591480592,830594383263,2902671,-1
545,1,STEP,830594455063,830597787930,3332867,-1
546,1,STEP,830597860129,830600569003,2708874,-1
547,1,STEP,830600639702,830603920570,3280868,-1
548,1,STEP,830603994069,830607427336,3433267,-1
549,1,STEP,830607501135,830610557905,3056770,-1
550,1,STEP,830610629905,830613781374,3151469,-1
551,1,STEP,830613853173,830616821844,2968671,-1
552,1,STEP,830616898443,830619849014,2950571,-1
553,1,STEP,830619922014,830623063083,3141069,-1
554,1,STEP,830623137382,830626524149,3386767,-1
555,1,STEP,830626598748,830629768117,3169369,-1
556,1,STEP,830629878116,830632722089,2843973,-1
557,1,STEP,830632796588,830635662460,2865872,-1
558,1,STEP,830635737859,830639210625,3472766,-1
559,1,STEP,830639286724,830642189996,2903272,-1
560,1,STEP,830642265895,830644928369,2662474,-1
561,1,STEP,830645038468,830647649243,2610775,-1
562,1,STEP,830647763342,830650443115,2679773,-1
563,1,STEP,830650556814,830653916381,3359567,-1
564,1,STEP,830654033380,830657520246,3486866,-1
565,1,STEP,830657632045,830660906813,3274768,-1
566,1,STEP,830661016412,830664242680,3226268,-1
567,1,STEP,830664321680,830668030443,3708763,-1
568,1,STEP,830668106643,830671113413,3006770,-1
569,1,STEP,830671233912,830674775477,3541565,-1
570,1,STEP,830674850977,830678598040,3747063,-1
571,1,STEP,830678676339,830682494902,3818563,-1
572,1,STEP,830682625001,830685833069,3208068,-1
573,1,STEP,830685947568,830689400334,3452766,-1
574,1,STEP,830689483034,830692856501,3373467,-1
575,1,STEP,830692954000,830697251158,4297158,-1
576,1,STEP,830697393456,830701080020,3686564,-1
577,1,STEP,830701197519,830704705085,3507566,-1
578,1,STEP,830704834483,830708757345,3922862,-1
579,1,STEP,830708854144,830712385110,3530966,-1
580,1,STEP,830712482909,830715453480,2970571,-1
581,1,STEP,830715546879,830718292152,2745273,-1
582,1,STEP,830718380551,830721733118,3352567,-1
583,1,STEP,830721820817,830724561891,2741074,-1
584,1,STEP,830724648490,830727643460,2994970,-1
585,1,STEP,830727734060,830730910229,3176169,-1
586,1,STEP,830731001128,830734465294,3464166,-1
587,1,STEP,830734563493,830737907960,3344467,-1
588,1,STEP,830738005259,830742786012,4780753,-1
589,1,STEP,830742882611,830746921572,4038961,-1
590,1,STEP,830747016071,830750380238,3364167,-1
591,1,STEP,830750508137,830755219891,4711754,-1
592,1,STEP,830755323690,830759101553,3777863,-1
593,1,STEP,830759226252,830762439920,3213668,-1
594,1,STEP,830762526219,830766020785,3494566,-1
595,1,STEP,830766141184,830770322843,4181659,-1
596,1,STEP,830770448342,830773399413,2951071,-1
597,1,STEP,830773528812,830776990678,3461866,-1
598,1,STEP,830777107977,830780197747,3089770,-1
599,1,STEP,830780306246,830783880911,3574665,-1
600,1,STEP,830783998609,830787401376,3402767,-1
601,1,STEP,830787518075,830791826833,4308758,-1
602,1,STEP,830791958332,830796261389,4303057,-1
603,1,STEP,830796382988,830800779145,4396157,-1
604,1,STEP,830800862245,830804866505,4004260,-1
605,1,STEP,830805002904,830809913356,4910452,-1
606,1,STEP,830810023555,830814171014,4147459,-1
607,1,STEP,830814281513,830817661980,3380467,-1
608,1,STEP,830817736280,830820772950,3036670,-1
609,1,STEP,830820847949,830825083508,4235559,-1
610,1,STEP,830825190507,830829704762,4514255,-1
611,1,STEP,830829840461,830833833522,3993061,-1
612,1,STEP,830833976021,830838200979,4224958,-1
613,1,STEP,830838330078,830841638646,3308568,-1
614,1,STEP,830841762445,830845255110,3492665,-1
615,1,STEP,830845373709,830848613278,3239569,-1
616,1,STEP,830848704777,830852012844,3308067,-1
617,1,STEP,830852094744,830855106814,3012070,-1
618,1,STEP,830855198013,830858884077,3686064,-1
619,1,STEP,830859004176,830862789539,3785363,-1
620,1,STEP,830862865538,830866098207,3232669,-1
621,1,STEP,830866182606,830869233976,3051370,-1
622,1,STEP,830869347775,830873068738,3720963,-1
623,1,STEP,830873190637,830877168198,3977561,-1
624,1,STEP,830877290797,830881976951,4686154,-1
625,1,STEP,830882098350,830886833104,4734754,-1
626,1,STEP,830886949203,830891099762,4150559,-1
627,1,STEP,830891236661,830895744517,4507856,-1
628,1,STEP,830895864416,830900503370,4638954,-1
629,1,STEP,830900619369,830904495631,3876262,-1
630,1,STEP,830904625230,830910064177,5438947,-1
631,1,STEP,830910214975,830914289335,4074360,-1
632,1,STEP,830914416734,830918961190,4544456,-1
633,1,STEP,830919093988,830923499645,4405657,-1
634,1,STEP,830923630444,830927437607,3807163,-1
635,1,STEP,830927513306,830930485677,2972371,-1
636,1,STEP,830930577476,830933879944,3302468,-1
637,1,STEP,830933980443,830937499708,3519265,-1
638,1,STEP,830937589408,830940852776,3263368,-1
639,1,STEP,830940940175,830943978245,3038070,-1
640,1,STEP,830944056644,830947285113,3228469,-1
641,1,STEP,830947370112,830950586280,3216168,-1
642,1,STEP,830950673580,830954079946,3406366,-1
643,1,STEP,830954170045,830957543512,3373467,-1
644,1,STEP,830957634112,830961105078,3470966,-1
645,1,STEP,830961189977,830964568744,3378767,-1
646,1,STEP,830964655843,830968898701,4242858,-1
647,1,STEP,830968988101,830973048761,4060660,-1
648,1,STEP,830973185460,830978080712,4895252,-1
649,1,STEP,830978215810,830982044673,3828863,-1
650,1,STEP,830982176172,830985432140,3255968,-1
651,1,STEP,830985518639,830988439410,2920771,-1
652,1,STEP,830988574809,830991970776,3395967,-1
653,1,STEP,830992082875,830994910147,2827272,-1
654,1,STEP,830995026646,830998327314,3300668,-1
655,1,STEP,830998443713,831001980878,3537165,-1
656,1,STEP,831002099277,831005329945,3230668,-1
657,1,STEP,831005444044,831008705712,3261668,-1
658,1,STEP,831008822411,831011674283,2851872,-1
659,1,STEP,831011790382,831015294248,3503866,-1
660,1,STEP,831015411447,831018868313,3456866,-1
661,1,STEP,831018982612,831022447478,3464866,-1
662,1,STEP,831022560177,831025654246,3094069,-1
663,1,STEP,831025749246,831029572508,3823262,-1
664,1,STEP,831029697707,831032996175,3298468,-1
665,1,STEP,831033084174,831036624839,3540665,-1
666,1,STEP,831036738338,831040023906,3285568,-1
667,1,STEP,831040158405,831043289274,3130869,-1
668,1,STEP,831043414373,831047410734,3996361,-1
669,1,STEP,831047532433,831050183807,2651374,-1
670,1,STEP,831050300105,831054126368,3826263,-1
671,1,STEP,831054245367,831057658434,3413067,-1
672,1,STEP,831057773232,831061088600,3315368,-1
673,1,STEP,831061202799,831064185770,2982971,-1
674,1,STEP,831064289069,831067803334,3514265,-1
675,1,STEP,831067934833,831071265200,3330367,-1
676,1,STEP,831071393199,831074237771,2844572,-1
677,1,STEP,831074358270,831077584239,3225969,-1
678,1,STEP,831077701438,831080250313,2548875,-1
679,1,STEP,831080364912,831083743678,3378766,-1
680,1,STEP,831083858177,831087775439,3917262,-1
681,1,STEP,831087876838,831092002198,4125360,-1
682,1,STEP,831092095697,831095897860,3802163,-1
683,1,STEP,831095979059,831100368416,4389357,-1
684,1,STEP,831100496115,831105391567,4895452,-1
685,1,STEP,831105534565,831110247419,4712854,-1
686,1,STEP,831110325419,831113143891,2818472,-1
687,1,STEP,831113216590,831116669257,3452667,-1
688,1,STEP,831116744056,831119650727,2906671,-1
689,1,STEP,831119721927,831122957695,3235768,-1
690,1,STEP,831123032494,831125963866,2931372,-1
691,1,STEP,831126035765,831129120235,3084470,-1
692,1,STEP,831129191434,831133287894,4096460,-1
693,1,STEP,831133366193,831135964768,2598575,-1
694,1,STEP,831136037367,831138835340,2797973,-1
695,1,STEP,831138909039,831141638212,2729173,-1
696,1,STEP,831141744211,831144360486,2616275,-1
697,1,STEP,831144471685,831147222458,2750773,-1
698,1,STEP,831147334357,831150435526,3101169,-1
699,1,STEP,831150551325,831153741894,3190569,-1
700,1,STEP,831153852793,831157463758,3610965,-1
701,1,STEP,831157576857,831161029823,3452966,-1
702,1,STEP,831161144522,831164594588,3450066,-1
703,1,STEP,831164672987,831167474460,2801473,-1
704,1,STEP,831167560259,831170603829,3043570,-1
705,1,STEP,831170678328,831173261503,2583175,-1
706,1,STEP,831173333202,831175850278,2517076,-1
707,1,STEP,831175921277,831179034647,3113370,-1
708,1,STEP,831179144846,831182265715,3120869,-1
709,1,STEP,831182381914,831185483384,3101470,-1
710,1,STEP,831185610482,831189413545,3803063,-1
711,1,STEP,831189519044,831192311417,2792373,-1
712,1,STEP,831192407516,831195385087,2977571,-1
713,1,STEP,831195483286,831199371148,3887862,-1
714,1,STEP,831199464047,831202414218,2950171,-1
715,1,STEP,831202507717,831205638087,3130370,-1
716,1,STEP,831205727986,831208790456,3062470,-1
717,1,STEP,831208882255,831211637728,2755473,-1
718,1,STEP,831211729727,831214425601,2695874,-1
719,1,STEP,831214519600,831217545370,3025770,-1
720,1,STEP,831217636369,831221010536,3374167,-1
721,1,STEP,831221104535,831223993907,2889372,-1
722,1,STEP,831224087406,831227800270,3712864,-1
723,1,STEP,831227892269,831231136137,3243868,-1
724,1,STEP,831231231636,831234774402,3542766,-1
725,1,STEP,831234866701,831238321167,3454466,-1
726,1,STEP,831238413666,831241634535,3220869,-1
727,1,STEP,831241724734,831245625896,3901162,-1
728,1,STEP,831245717995,831248765765,3047770,-1
729,1,STEP,831248853864,831252292230,3438366,-1
730,1,STEP,831252387329,831256054394,3667065,-1
731,1,STEP,831256146793,831259291862,3145069,-1
732,1,STEP,831259396161,831262750428,3354267,-1
733,1,STEP,831262867927,831266154095,3286168,-1
734,1,STEP,831266229094,831268753669,2524575,-1
735,1,STEP,831268835969,831271498343,2662374,-1
736,1,STEP,831271592342,831274956609,3364267,-1
737,1,STEP,831275053708,831277848680,2794972,-1
738,1,STEP,831277953079,831281148948,3195869,-1
739,1,STEP,831281239947,831284500715,3260768,-1
740,1,STEP,831284597215,831287419087,2821872,-1
741,1,STEP,831287511986,831290519457,3007471,-1
742,1,STEP,831290613956,831293770225,3156269,-1
743,1,STEP,831293861224,831297526388,3665164,-1
744,1,STEP,831297620987,831300638958,3017971,-1
745,1,STEP,831300732257,831304239622,3507365,-1
746,1,STEP,831304333622,831307557390,3223768,-1
747,1,STEP,831307650589,831310240964,2590375,-1
748,1,STEP,831310333963,831313535032,3201069,-1
749,1,STEP,831313626731,831316097106,2470375,-1
750,1,STEP,831316189606,831319366675,3177069,-1
751,1,STEP,831319465474,831322674742,3209268,-1
752,1,STEP,831322769741,831325852511,3082770,-1
753,1,STEP,831325939810,831328527285,2587475,-1
754,1,STEP,831328600984,831331906752,3305768,-1
755,1,STEP,831331980951,831334602826,2621875,-1
756,1,STEP,831334674725,831337706395,3031670,-1
757,1,STEP,831337779394,831340594967,2815573,-1
758,1,STEP,831340687366,831343938634,3251268,-1
759,1,STEP,831344021033,831347279402,3258369,-1
760,1,STEP,831347363401,831349993375,2629974,-1
761,1,STEP,831350074274,831353375642,3301368,-1
762,1,STEP,831353461441,831356461912,3000471,-1
763,1,STEP,831356547111,831359379083,2831972,-1
764,1,STEP,831359463982,831362224355,2760373,-1
765,1,STEP,831362307855,831365117627,2809772,-1
766,1,STEP,831365200626,831368299796,3099170,-1
767,1,STEP,831368381695,831371828162,3446467,-1
768,1,STEP,831371942960,831374773633,2830673,-1
769,1,STEP,831374857132,831377225209,2368077,-1
770,1,STEP,831377309608,831380609576,3299968,-1
771,1,STEP,831380693075,831383719945,3026870,-1
772,1,STEP,831383804144,831386700616,2896472,-1
773,1,STEP,831386783115,831390313481,3530366,-1
774,1,STEP,831390399080,831393253152,2854072,-1
775,1,STEP,831393340951,831396390521,3049570,-1
776,1,STEP,831396472721,831399803288,3330567,-1
777,1,STEP,831399886287,831402760859,2874572,-1
778,1,STEP,831402842958,831405857429,3014471,-1
779,1,STEP,831405948328,831409149997,3201669,-1
780,1,STEP,831409234396,831411855470,2621074,-1
781,1,STEP,831411939469,831414328746,2389277,-1
782,1,STEP,831414414545,831417503215,3088670,-1
783,1,STEP,831417586514,831420476886,2890372,-1
784,1,STEP,831420560285,831423395557,2835272,-1
785,1,STEP,831423488256,831426695825,3207569,-1
786,1,STEP,831426784824,831429930093,3145269,-1
787,1,STEP,831430013993,831432719766,2705773,-1
788,1,STEP,831432802665,831436182832,3380167,-1
789,1,STEP,831436266231,831439500700,3234469,-1
790,1,STEP,831439585099,831443121664,3536565,-1
791,1,STEP,831443210564,831446484432,3273868,-1
792,1,STEP,831446573931,831449796199,3222268,-1
793,1,STEP,831449901198,831453051567,3150369,-1
794,1,STEP,831453134467,831456536833,3402366,-1
795,1,STEP,831456620132,831459734702,3114570,-1
796,1,STEP,831459819001,831463220368,3401367,-1
797,1,STEP,831463301867,831465955541,2653674,-1
798,1,STEP,831466043440,831469267709,3224269,-1
799,1,STEP,831469351008,831472279479,2928471,-1
800,1,STEP,831472368978,831475218551,2849573,-1
801,1,STEP,831475299750,831478681917,3382167,-1
802,1,STEP,831478765616,831481300791,2535175,-1
803,1,STEP,831481382390,831485081754,3699364,-1
804,1,STEP,831485165653,831488726819,3561166,-1
805,1,STEP,831488810518,831491576491,2765973,-1
806,1,STEP,831491665390,831494861059,3195669,-1
807,1,STEP,831494944258,831498030728,3086470,-1
808,1,STEP,831498114327,831500828700,2714373,-1
809,1,STEP,831500917399,831503827171,2909772,-1
810,1,STEP,831503909570,831506494545,2584975,-1
811,1,STEP,831506583944,831509682514,3098570,-1
812,1,STEP,831509765213,831513052381,3287168,-1
813,1,STEP,831513139280,831516129551,2990271,-1
814,1,STEP,831516213450,831519110121,2896671,-1
815,1,STEP,831519193821,831522937384,3743563,-1
816,1,STEP,831523022783,831526751847,3729064,-1
817,1,STEP,831526836946,831530210213,3373267,-1
818,1,STEP,831530302212,831533431381,3129169,-1
819,1,STEP,831533521281,831536612350,3091069,-1
820,1,STEP,831536697549,831539683120,2985571,-1
821,1,STEP,831539773019,831542815390,3042371,-1
822,1,STEP,831542897289,831545688362,2791073,-1
823,1,STEP,831545773761,831548969229,3195468,-1
824,1,STEP,831549052329,831551543104,2490775,-1
825,1,STEP,831551641203,831554397376,2756173,-1
826,1,STEP,831554477076,831557678844,3201768,-1
827,1,STEP,831557758344,831560260719,2502375,-1
828,1,STEP,831560341318,831563689986,3348668,-1
829,1,STEP,831563780885,831566735356,2954471,-1
830,1,STEP,831566824055,831569524628,2700573,-1
831,1,STEP,831569610028,831572415600,2805572,-1
832,1,STEP,831572497299,831575598769,3101470,-1
833,1,STEP,831575686768,831578332042,2645274,-1
834,1,STEP,831578412142,831581486211,3074069,-1
835,1,STEP,831581570811,831584508182,2937371,-1
836,1,STEP,831584595281,831588061747,3466466,-1
837,1,STEP,831588142546,831591116017,2973471,-1
838,1,STEP,831591198917,831593946890,2747973,-1
839,1,STEP,831594027389,831596693663,2666274,-1
840,1,STEP,831596773562,831599688934,2915372,-1
841,1,STEP,831599769133,831602721904,2952771,-1
842,1,STEP,831602809203,831605607976,2798773,-1
843,1,STEP,831605693775,831608971643,3277868,-1
844,1,STEP,831609058742,831612337210,3278468,-1
845,1,STEP,831612418109,831615653677,3235568,-1
846,1,STEP,831615736177,831619117244,3381067,-1
847,1,STEP,831619201143,831622511210,3310067,-1
848,1,STEP,831622593910,831625931777,3337867,-1
849,1,STEP,831626020976,831629574141,3553165,-1
850,1,STEP,831629658540,831632486313,2827773,-1
851,1,STEP,831632570112,831636004178,3434066,-1
852,1,STEP,831636114677,831640101938,3987261,-1
853,1,STEP,831640231837,831643778702,3546865,-1
854,1,STEP,831643895901,831646808873,2912972,-1
855,1,STEP,831646892772,831649753044,2860272,-1
856,1,STEP,831649835943,831652680815,2844872,-1
857,1,STEP,831652765815,831655845884,3080069,-1
858,1,STEP,831655930484,831659362350,3431866,-1
859,1,STEP,831659450349,831662976715,3526366,-1
860,1,STEP,831663075714,831666375781,3300067,-1
861,1,STEP,831666477580,831669708949,3231369,-1
862,1,STEP,831669807148,831673305414,3498266,-1
863,1,STEP,831673411113,831676872079,3460966,-1
864,1,STEP,831676976278,831680236046,3259768,-1
865,1,STEP,831680340045,831683530814,3190769,-1
866,1,STEP,831683627313,831686494185,2866872,-1
867,1,STEP,831686591084,831689756253,3165169,-1
868,1,STEP,831689846952,831692995421,3148469,-1
869,1,STEP,831693090820,831696703785,3612965,-1
870,1,STEP,831696801084,831699970853,3169769,-1
871,1,STEP,831700076552,831702913724,2837172,-1
872,1,STEP,831703006623,831706254192,3247569,-1
873,1,STEP,831706345391,831709417261,3071870,-1
874,1,STEP,831709517160,831712360232,2843072,-1
875,1,STEP,831712456531,831715702499,3245968,-1
876,1,STEP,831715799898,831718842468,3042570,-1
877,1,STEP,831718932868,831721852239,2919371,-1
878,1,STEP,831721955738,831725412204,3456466,-1
879,1,STEP,831725504103,831728892370,3388267,-1
880,1,STEP,831728978069,831732696933,3718864,-1
881,1,STEP,831732822532,831735784703,2962171,-1
882,1,STEP,831735866002,831738767874,2901872,-1
883,1,STEP,831738890472,831742648636,3758164,-1
884,1,STEP,831742777334,831745438508,2661174,-1
885,1,STEP,831745540807,831749211071,3670264,-1
886,1,STEP,831749309471,831752608138,3298667,-1
887,1,STEP,831752699137,831755814407,3115270,-1
888,1,STEP,831755899506,831758708179,2808673,-1
889,1,STEP,831758788378,831762233144,3444766,-1
890,1,STEP,831762325443,831765847509,3522066,-1
891,1,STEP,831765974508,831770147767,4173259,-1
892,1,STEP,831770249366,831773960929,3711563,-1
893,1,STEP,831774086928,831776985400,2898472,-1
894,1,STEP,831777099999,831780826662,3726663,-1
895,1,STEP,831780908062,831783605535,2697473,-1
896,1,STEP,831783687734,831787011202,3323468,-1
897,1,STEP,831787158000,831790486368,3328368,-1
898,1,STEP,831790575767,831793393039,2817272,-1
899,1,STEP,831793478639,831797126603,3647964,-1
900,1,STEP,831797209002,831799957275,2748273,-1
901,1,STEP,831800047874,831803299943,3252069,-1
902,1,STEP,831803399842,831806412412,3012570,-1
903,1,STEP,831806501011,831809701780,3200769,-1
904,1,STEP,831809785879,831813140746,3354867,-1
905,1,STEP,831813224546,831816151617,2927071,-1
906,1,STEP,831816240216,831819311886,3071670,-1
907,1,STEP,831819395885,831822658653,3262768,-1
908,1,STEP,831822745252,831825563325,2818073,-1
909,1,STEP,831825650424,831828350898,2700474,-1
910,1,STEP,831828433697,831831223470,2789773,-1
911,1,STEP,831831311669,831834797635,3485966,-1
912,1,STEP,831834896834,831837396209,2499375,-1
913,1,STEP,831837480708,831840594578,3113870,-1
914,1,STEP,831840678377,831843794247,3115870,-1
915,1,STEP,831843877346,831847009215,3131869,-1
916,1,STEP,831847093614,831849709289,2615675,-1
917,1,STEP,831849796988,831852296963,2499975,-1
918,1,STEP,831852384363,831855381833,2997470,-1
919,1,STEP,831855466632,831858724201,3257569,-1
920,1,STEP,831858798700,831862131467,3332767,-1
921,1,STEP,831862205267,831865581734,3376467,-1
922,1,STEP,831865654733,831868381806,2727073,-1
923,1,STEP,831868454506,831871864272,3409766,-1
924,1,STEP,831872004371,831874678645,2674274,-1
925,1,STEP,831874752344,831878055312,3302968,-1
926,1,STEP,831878178010,831881300280,3122270,-1
927,1,STEP,831881374279,831883979254,2604975,-1
928,1,STEP,831884091853,831886837826,2745973,-1
929,1,STEP,831886952425,831890072294,3119869,-1
930,1,STEP,831890191293,831893103164,2911871,-1
931,1,STEP,831893218363,831895940937,2722574,-1
932,1,STEP,831896055136,831899591201,3536065,-1
933,1,STEP,831899712600,831902922068,3209468,-1
934,1,STEP,831903036467,831906352535,3316068,-1
935,1,STEP,831906467534,831910044799,3577265,-1
936,1,STEP,831910159098,831913621564,3462466,-1
937,1,STEP,831913735263,831916607835,2872572,-1
938,1,STEP,831916720034,831920139400,3419366,-1
939,1,STEP,831920265199,831922945973,2680774,-1
940,1,STEP,831923059272,831926204441,3145169,-1
941,1,STEP,831926325240,831929217011,2891771,-1
942,1,STEP,831929331010,831932193382,2862372,-1
943,1,STEP,831932307381,831935213953,2906572,-1
944,1,STEP,831935327552,831938450121,3122569,-1
945,1,STEP,831938568820,831941897187,3328367,-1
946,1,STEP,831942009786,831945570251,3560465,-1
947,1,STEP,831945685950,831948795420,3109470,-1
948,1,STEP,831948907819,831951309995,2402176,-1
949,1,STEP,831951422094,831955130958,3708864,-1
950,1,STEP,831955246557,831958783722,3537165,-1
951,1,STEP,831958898321,831961949691,3051370,-1
952,1,STEP,831962065690,831965531156,3465466,-1
953,1,STEP,831965646055,831968080931,2434876,-1
954,1,STEP,831968199030,831971616697,3417667,-1
955,1,STEP,831971737496,831975192562,3455066,-1
956,1,STEP,831975328460,831979639218,4310758,-1
957,1,STEP,831979760017,831983009985,3249968,-1
958,1,STEP,831983131184,831986228954,3097770,-1
959,1,STEP,831986349353,831989264724,2915371,-1
960,1,STEP,831989381823,831992604392,3222569,-1
961,1,STEP,831992724790,831996206256,3481466,-1
962,1,STEP,831996320955,831999641223,3320268,-1
963,1,STEP,831999758422,832002745492,2987070,-1
964,1,STEP,832002858891,832006005661,3146770,-1
965,1,STEP,832006125759,832009628825,3503066,-1
966,1,STEP,832009742124,832012992692,3250568,-1
967,1,STEP,832013093991,832016024963,2930972,-1
968,1,STEP,832016106962,832019218731,3111769,-1
969,1,STEP,832019303030,832021858506,2555476,-1
970,1,STEP,832021954705,832024642378,2687673,-1
971,1,STEP,832024723277,832027645249,2921972,-1
972,1,STEP,832027742748,832030778018,3035270,-1
973,1,STEP,832030859217,832033741689,2882472,-1
974,1,STEP,832033826488,832036803359,2976871,-1
975,1,STEP,832036885159,832039941329,3056170,-1
976,1,STEP,832040024328,832043172597,3148269,-1
977,1,STEP,832043254296,832045918970,2664674,-1
978,1,STEP,832046004169,832049111039,3106870,-1
979,1,STEP,832049192638,832052496706,3304068,-1
980,1,STEP,832052582505,832055676575,3094070,-1
981,1,STEP,832055760274,832058504047,2743773,-1
982,1,STEP,832058590546,832061684216,3093670,-1
983,1,STEP,832061768415,832064912185,3143770,-1
984,1,STEP,832064996384,832067768157,2771773,-1
985,1,STEP,832067851356,832070689628,2838272,-1
986,1,STEP,832070770727,832073454301,2683574,-1
987,1,STEP,832073539400,832076770769,3231369,-1
988,1,STEP,832076859468,832079916138,3056670,-1
989,1,STEP,832079997037,832082920908,2923871,-1
990,1,STEP,832083005408,832085480883,2475475,-1
991,1,STEP,832085560783,832088525654,2964871,-1
992,1,STEP,832088607753,832091658823,3051070,-1
993,1,STEP,832091742022,832094654694,2912672,-1
994,1,STEP,832094736093,832097406967,2670874,-1
995,1,STEP,832097492566,832101005432,3512866,-1
996,1,STEP,832101091631,832103986202,2894571,-1
997,1,STEP,832104074502,832107166671,3092169,-1
998,1,STEP,832107250271,832110252641,3002370,-1
999,1,STEP,832110340840,832113400310,3059470,-1
