Gen,Resource,Stamp,TimeStamp_Start,TimeStamp_End,Duration,Indiv_id
0,1,FirstEvaluation,803720933488,804524383777,803450289,-1
0,1,STEP,804524571275,804530426204,5854929,-1
1,1,STEP,804530500403,804534966748,4466345,-1
2,1,STEP,804535036348,804539895688,4859340,-1
3,1,STEP,804539966787,804544283535,4316748,-1
4,1,STEP,804544351334,804547809092,3457758,-1
5,1,STEP,804547876791,804552482135,4605344,-1
6,1,STEP,804552552034,804556923481,4371447,-1
7,1,STEP,804556989280,804561183129,4193849,-1
8,1,STEP,804561250628,804564906183,3655555,-1
9,1,STEP,804564973683,804569924122,4950439,-1
10,1,STEP,804569991821,804573588278,3596457,-1
11,1,STEP,804573655577,804578591917,4936340,-1
12,1,STEP,804578663516,804583854852,5191336,-1
13,1,STEP,804583925152,804588991090,5065938,-1
14,1,STEP,804589124788,804594647221,5522433,-1
15,1,STEP,804594763920,804598843970,4080050,-1
16,1,STEP,804598964868,804604245604,5280736,-1
17,1,STEP,804604365002,804609406841,5041839,-1
18,1,STEP,804609478540,804613677989,4199449,-1
19,1,STEP,804613769788,804617702740,3932952,-1
20,1,STEP,804617813939,804623121174,5307235,-1
21,1,STEP,804623231172,804627614119,4382947,-1
22,1,STEP,804627714718,804631571371,3856653,-1
23,1,STEP,804631691569,804637048404,5356835,-1
24,1,STEP,804637183602,804643528725,6345123,-1
25,1,STEP,804643656124,804649445053,5788929,-1
26,1,STEP,804649582751,804654709589,5126838,-1
27,1,STEP,804654781688,804659926625,5144937,-1
28,1,STEP,804660052324,804664404871,4352547,-1
29,1,STEP,804664477770,804669978603,5500833,-1
30,1,STEP,804670051902,804674446848,4394946,-1
31,1,STEP,804674518247,804678851995,4333748,-1
32,1,STEP,804678956993,804683217041,4260048,-1
33,1,STEP,804683342340,804687167793,3825453,-1
34,1,STEP,804687270292,804691638639,4368347,-1
35,1,STEP,804691749437,804695678489,3929052,-1
36,1,STEP,804695796688,804700080736,4284048,-1
37,1,STEP,804700195934,804703930789,3734855,-1
38,1,STEP,804704021288,804707528045,3506757,-1
39,1,STEP,804707651943,804712348486,4696543,-1
40,1,STEP,804712471585,804716884131,4412546,-1
41,1,STEP,804717011529,804721273877,4262348,-1
42,1,STEP,804721345877,804725621024,4275147,-1
43,1,STEP,804725698523,804729708375,4009852,-1
44,1,STEP,804729801873,804733717926,3916053,-1
45,1,STEP,804733849924,804739470856,5620932,-1
46,1,STEP,804739604454,804743759303,4154849,-1
47,1,STEP,804743865302,804747124762,3259460,-1
48,1,STEP,804747203661,804751162913,3959252,-1
49,1,STEP,804751247812,804754561672,3313860,-1
50,1,STEP,804754645671,804758619822,3974151,-1
51,1,STEP,804758696621,804762231378,3534757,-1
52,1,STEP,804762304077,804766221130,3917053,-1
53,1,STEP,804766308328,804769708087,3399759,-1
54,1,STEP,804769813786,804773201644,3387858,-1
55,1,STEP,804773307943,804776873100,3565157,-1
56,1,STEP,804776984198,804781150048,4165850,-1
57,1,STEP,804781238246,804784278909,3040663,-1
58,1,STEP,804784373508,804788160762,3787254,-1
59,1,STEP,804788317360,804791357823,3040463,-1
60,1,STEP,804791445322,804794918680,3473358,-1
61,1,STEP,804795030078,804798944331,3914253,-1
62,1,STEP,804799046129,804802690785,3644656,-1
63,1,STEP,804802770084,804806633337,3863253,-1
64,1,STEP,804806745336,804811214781,4469445,-1
65,1,STEP,804811326980,804815860724,4533744,-1
66,1,STEP,804815943023,804818696890,2753867,-1
67,1,STEP,804818784689,804821798352,3013663,-1
68,1,STEP,804821929750,804826473295,4543545,-1
69,1,STEP,804826601894,804829637656,3035762,-1
70,1,STEP,804829711656,804832699619,2987963,-1
71,1,STEP,804832776918,804836297475,3520557,-1
72,1,STEP,804836384374,804840071129,3686755,-1
73,1,STEP,804840154728,804843842883,3688155,-1
74,1,STEP,804843954682,804847089444,3134762,-1
75,1,STEP,804847193842,804850308705,3114863,-1
76,1,STEP,804850421603,804853346367,2924764,-1
77,1,STEP,804853427967,804857596816,4168849,-1
78,1,STEP,804857727414,804862231659,4504245,-1
79,1,STEP,804862361658,804866641505,4279847,-1
80,1,STEP,804866765204,804871434447,4669243,-1
81,1,STEP,804871564045,804875758694,4194649,-1
82,1,STEP,804875891293,804880587035,4695742,-1
83,1,STEP,804880719234,804884822684,4103450,-1
84,1,STEP,804884947982,804889569026,4621044,-1
85,1,STEP,804889711324,804894019072,4307748,-1
86,1,STEP,804894135170,804898550016,4414846,-1
87,1,STEP,804898637015,804902413769,3776754,-1
88,1,STEP,804902504768,804906113024,3608256,-1
89,1,STEP,804906216623,804909674781,3458158,-1
90,1,STEP,804909797179,804913713532,3916353,-1
91,1,STEP,804913802631,804918904568,5101937,-1
92,1,STEP,804919038167,804924040906,5002739,-1
93,1,STEP,804924172304,804928190355,4018051,-1
94,1,STEP,804928321454,804932706700,4385246,-1
95,1,STEP,804932840998,804937884137,5043139,-1
96,1,STEP,804938016635,804942437482,4420847,-1
97,1,STEP,804942567580,804946927327,4359747,-1
98,1,STEP,804947057225,804951412672,4355447,-1
99,1,STEP,804951542771,804956375912,4833141,-1
100,1,STEP,804956506610,804960568861,4062251,-1
101,1,STEP,804960697359,804965089305,4391946,-1
102,1,STEP,804965214804,804969881947,4667143,-1
103,1,STEP,804970020245,804974193194,4172949,-1
104,1,STEP,804974327493,804978553541,4226048,-1
105,1,STEP,804978684340,804983844077,5159737,-1
106,1,STEP,804983977275,804988765817,4788542,-1
107,1,STEP,804988891415,804992982165,4090750,-1
108,1,STEP,804993085264,804996979417,3894153,-1
109,1,STEP,804997078515,805000562073,3483558,-1
110,1,STEP,805000657272,805004185129,3527857,-1
111,1,STEP,805004264328,805007610887,3346559,-1
112,1,STEP,805007711886,805010979246,3267360,-1
113,1,STEP,805011064445,805013856411,2791966,-1
114,1,STEP,805013984709,805017574866,3590157,-1
115,1,STEP,805017670964,805020767527,3096563,-1
116,1,STEP,805020837726,805024463982,3626256,-1
117,1,STEP,805024539981,805027931639,3391658,-1
118,1,STEP,805028014138,805031806192,3792054,-1
119,1,STEP,805031907991,805035528047,3620056,-1
120,1,STEP,805035612246,805039075004,3462758,-1
121,1,STEP,805039158103,805042436363,3278260,-1
122,1,STEP,805042535061,805045521825,2986764,-1
123,1,STEP,805045611224,805048607087,2995863,-1
124,1,STEP,805048697486,805052296342,3598856,-1
125,1,STEP,805052395041,805055441404,3046363,-1
126,1,STEP,805055527003,805059357256,3830253,-1
127,1,STEP,805059522754,805063934701,4411947,-1
128,1,STEP,805064061299,805067815053,3753754,-1
129,1,STEP,805067907252,805071374310,3467058,-1
130,1,STEP,805071471709,805074609370,3137661,-1
131,1,STEP,805074709069,805077746732,3037663,-1
132,1,STEP,805077829231,805080951893,3122662,-1
133,1,STEP,805081043892,805084499350,3455458,-1
134,1,STEP,805084599049,805088188205,3589156,-1
135,1,STEP,805088267604,805091502164,3234560,-1
136,1,STEP,805091584963,805094731425,3146462,-1
137,1,STEP,805094830624,805098852875,4022251,-1
138,1,STEP,805098953474,805102304633,3351159,-1
139,1,STEP,805102395432,805105637792,3242360,-1
140,1,STEP,805105722391,805109236248,3513857,-1
141,1,STEP,805109330547,805112550408,3219861,-1
142,1,STEP,805112621307,805116378961,3757654,-1
143,1,STEP,805116451860,805119485723,3033863,-1
144,1,STEP,805119557323,805121943593,2386270,-1
145,1,STEP,805122047392,805125741547,3694155,-1
146,1,STEP,805125846546,805128689711,2843165,-1
147,1,STEP,805128805010,805131600776,2795766,-1
148,1,STEP,805131713174,805134648839,2935665,-1
149,1,STEP,805134761937,805138163996,3402059,-1
150,1,STEP,805138273094,805141600654,3327560,-1
151,1,STEP,805141669053,805145360208,3691155,-1
152,1,STEP,805145446007,805148946764,3500757,-1
153,1,STEP,805149040663,805151964127,2923464,-1
154,1,STEP,805152046826,805155447685,3400859,-1
155,1,STEP,805155550684,805159094641,3543957,-1
156,1,STEP,805159169240,805162067604,2898364,-1
157,1,STEP,805162138603,805165576262,3437659,-1
158,1,STEP,805165662561,805169318316,3655755,-1
159,1,STEP,805169388715,805172499277,3110562,-1
160,1,STEP,805172566376,805175999035,3432659,-1
161,1,STEP,805176071534,805179346294,3274760,-1
162,1,STEP,805179417493,805182746352,3328859,-1
163,1,STEP,805182851051,805186012012,3160961,-1
164,1,STEP,805186113511,805189775267,3661756,-1
165,1,STEP,805189897265,805193348923,3451658,-1
166,1,STEP,805193461222,805196890480,3429258,-1
167,1,STEP,805196963679,805200225739,3262060,-1
168,1,STEP,805200316238,805203722697,3406459,-1
169,1,STEP,805203808096,805207099455,3291359,-1
170,1,STEP,805207176254,805210628212,3451958,-1
171,1,STEP,805210727311,805214354267,3626956,-1
172,1,STEP,805214447666,805217513828,3066162,-1
173,1,STEP,805217594727,805221647878,4053151,-1
174,1,STEP,805221776677,805225283934,3507257,-1
175,1,STEP,805225387532,805228567394,3179862,-1
176,1,STEP,805228647993,805232635044,3987051,-1
177,1,STEP,805232728343,805236393398,3665055,-1
178,1,STEP,805236486697,805239455661,2968964,-1
179,1,STEP,805239534760,805243368113,3833353,-1
180,1,STEP,805243449012,805247344765,3895753,-1
181,1,STEP,805247473563,805251220318,3746755,-1
182,1,STEP,805251295317,805254207581,2912264,-1
183,1,STEP,805254305980,805257561640,3255660,-1
184,1,STEP,805257631539,805261556492,3924953,-1
185,1,STEP,805261630191,805265270246,3640055,-1
186,1,STEP,805265375045,805268756504,3381459,-1
187,1,STEP,805268882702,805272700456,3817754,-1
188,1,STEP,805272844954,805276449410,3604456,-1
189,1,STEP,805276526109,805279164277,2638168,-1
190,1,STEP,805279261276,805282369438,3108162,-1
191,1,STEP,805282469437,805285743497,3274060,-1
192,1,STEP,805285827396,805288715361,2887965,-1
193,1,STEP,805288786960,805291962521,3175561,-1
194,1,STEP,805292036720,805295205481,3168761,-1
195,1,STEP,805295294880,805298590340,3295460,-1
196,1,STEP,805298682839,805302371194,3688355,-1
197,1,STEP,805302445893,805305422657,2976764,-1
198,1,STEP,805305524456,805308997213,3472757,-1
199,1,STEP,805309087212,805312484471,3397259,-1
200,1,STEP,805312567070,805315663532,3096462,-1
201,1,STEP,805315789831,805320526473,4736642,-1
202,1,STEP,805320664871,805325219616,4554745,-1
203,1,STEP,805325292515,805328139580,2847065,-1
204,1,STEP,805328211279,805331490039,3278760,-1
205,1,STEP,805331558838,805334575102,3016264,-1
206,1,STEP,805334646701,805338471354,3824653,-1
207,1,STEP,805338544153,805341562116,3017963,-1
208,1,STEP,805341634115,805344751877,3117762,-1
209,1,STEP,805344837976,805348127536,3289560,-1
210,1,STEP,805348196136,805350736605,2540469,-1
211,1,STEP,805350808104,805353948665,3140561,-1
212,1,STEP,805354020365,805357224925,3204560,-1
213,1,STEP,805357293425,805361084378,3790953,-1
214,1,STEP,805361179877,805364605035,3425158,-1
215,1,STEP,805364694234,805367791797,3097563,-1
216,1,STEP,805367883896,805371655350,3771454,-1
217,1,STEP,805371738549,805374862610,3124061,-1
218,1,STEP,805374954109,805378731463,3777354,-1
219,1,STEP,805378812062,805381857725,3045663,-1
220,1,STEP,805381985924,805385785077,3799153,-1
221,1,STEP,805385902476,805389288735,3386259,-1
222,1,STEP,805389361834,805393789280,4427446,-1
223,1,STEP,805393942578,805398242825,4300247,-1
224,1,STEP,805398330824,805401713083,3382259,-1
225,1,STEP,805401809282,805405330239,3520957,-1
226,1,STEP,805405418038,805408668598,3250560,-1
227,1,STEP,805408756297,805412153956,3397659,-1
228,1,STEP,805412252655,805415192519,2939864,-1
229,1,STEP,805415312717,805418716876,3404159,-1
230,1,STEP,805418823175,805422522530,3699355,-1
231,1,STEP,805422637028,805426045487,3408459,-1
232,1,STEP,805426158385,805428744654,2586269,-1
233,1,STEP,805428854352,805432326610,3472258,-1
234,1,STEP,805432439509,805435400773,2961264,-1
235,1,STEP,805435476572,805439687620,4211048,-1
236,1,STEP,805439766619,805442650584,2883965,-1
237,1,STEP,805442723383,805446537937,3814554,-1
238,1,STEP,805446620836,805449580800,2959964,-1
239,1,STEP,805449653599,805453164856,3511257,-1
240,1,STEP,805453251255,805456842511,3591256,-1
241,1,STEP,805456939410,805460090372,3150962,-1
242,1,STEP,805460160571,805463226633,3066062,-1
243,1,STEP,805463303332,805466917988,3614656,-1
244,1,STEP,805467017587,805470645643,3628056,-1
245,1,STEP,805470725142,805474846892,4121750,-1
246,1,STEP,805474930691,805477512659,2581968,-1
247,1,STEP,805477601358,805480636221,3034863,-1
248,1,STEP,805480734020,805483951981,3217961,-1
249,1,STEP,805484032280,805487414139,3381859,-1
250,1,STEP,805487504037,805491529488,4025451,-1
251,1,STEP,805491606687,805494782549,3175862,-1
252,1,STEP,805494857548,805498293806,3436258,-1
253,1,STEP,805498366305,805501302269,2935964,-1
254,1,STEP,805501405868,805504717128,3311260,-1
255,1,STEP,805504808126,805508221985,3413859,-1
256,1,STEP,805508347183,805511562444,3215261,-1
257,1,STEP,805511646543,805515337898,3691355,-1
258,1,STEP,805515429897,805518337162,2907265,-1
259,1,STEP,805518417161,805522531010,4113849,-1
260,1,STEP,805522659409,805527218753,4559344,-1
261,1,STEP,805527338452,805530847209,3508757,-1
262,1,STEP,805530923908,805533842473,2918565,-1
263,1,STEP,805533934271,805537910323,3976052,-1
264,1,STEP,805537987122,805541231982,3244860,-1
265,1,STEP,805541304282,805543927750,2623468,-1
266,1,STEP,805544001049,805547263809,3262760,-1
267,1,STEP,805547339608,805550823966,3484358,-1
268,1,STEP,805550900865,805553532533,2631668,-1
269,1,STEP,805553599932,805556633995,3034063,-1
270,1,STEP,805556707294,805560040853,3333559,-1
271,1,STEP,805560113252,805563387012,3273760,-1
272,1,STEP,805563461012,805566601473,3140461,-1
273,1,STEP,805566676372,805569035744,2359372,-1
274,1,STEP,805569104143,805571726911,2622768,-1
275,1,STEP,805571799010,805575006171,3207161,-1
276,1,STEP,805575075370,805578276331,3200961,-1
277,1,STEP,805578351430,805581240095,2888665,-1
278,1,STEP,805581313194,805584300158,2986964,-1
279,1,STEP,805584371557,805587382920,3011363,-1
280,1,STEP,805587455219,805590592981,3137762,-1
281,1,STEP,805590666680,805593227349,2560669,-1
282,1,STEP,805593298448,805596242012,2943564,-1
283,1,STEP,805596316411,805599168176,2851765,-1
284,1,STEP,805599242075,805603130028,3887953,-1
285,1,STEP,805603262326,805608208866,4946540,-1
286,1,STEP,805608341864,805613354703,5012839,-1
287,1,STEP,805613487602,805618057246,4569644,-1
288,1,STEP,805618190544,805622938087,4747543,-1
289,1,STEP,805623074585,805626785540,3710955,-1
290,1,STEP,805626914238,805630802791,3888553,-1
291,1,STEP,805630879490,805634991440,4111950,-1
292,1,STEP,805635128638,805640324675,5196037,-1
293,1,STEP,805640415573,805643525036,3109463,-1
294,1,STEP,805643601435,805648158479,4557044,-1
295,1,STEP,805648289978,805652185630,3895652,-1
296,1,STEP,805652265429,805655131694,2866265,-1
297,1,STEP,805655210093,805658248056,3037963,-1
298,1,STEP,805658324555,805661555516,3230961,-1
299,1,STEP,805661630315,805665786064,4155749,-1
300,1,STEP,805665864363,805668982225,3117862,-1
301,1,STEP,805669057124,805672065988,3008864,-1
302,1,STEP,805672140387,805675667544,3527157,-1
303,1,STEP,805675761943,805679318199,3556256,-1
304,1,STEP,805679434098,805682697558,3263460,-1
305,1,STEP,805682771557,805685933219,3161662,-1
306,1,STEP,805686016718,805689890770,3874052,-1
307,1,STEP,805689971669,805692981633,3009964,-1
308,1,STEP,805693055632,805696406791,3351159,-1
309,1,STEP,805696483890,805699363855,2879965,-1
310,1,STEP,805699451554,805703585903,4134349,-1
311,1,STEP,805703710502,805708257747,4547245,-1
312,1,STEP,805708335646,805711770104,3434458,-1
313,1,STEP,805711846303,805714958865,3112562,-1
314,1,STEP,805715034864,805718414123,3379259,-1
315,1,STEP,805718550421,805723330363,4779942,-1
316,1,STEP,805723471661,805727031818,3560157,-1
317,1,STEP,805727109417,805730150080,3040663,-1
318,1,STEP,805730246678,805733831135,3584457,-1
319,1,STEP,805733930434,805738539877,4609443,-1
320,1,STEP,805738651376,805742714427,4063051,-1
321,1,STEP,805742838325,805746979175,4140850,-1
322,1,STEP,805747111973,805751812216,4700243,-1
323,1,STEP,805751945714,805757257749,5312035,-1
324,1,STEP,805757389248,805761711695,4322447,-1
325,1,STEP,805761845793,805766899432,5053639,-1
326,1,STEP,805767032430,805772263166,5230736,-1
327,1,STEP,805772392065,805776977209,4585144,-1
328,1,STEP,805777109307,805781182358,4073051,-1
329,1,STEP,805781312756,805784990111,3677355,-1
330,1,STEP,805785078410,805788468469,3390059,-1
331,1,STEP,805788546068,805792137424,3591356,-1
332,1,STEP,805792242623,805795014989,2772366,-1
333,1,STEP,805795115488,805798645545,3530057,-1
334,1,STEP,805798737944,805801778307,3040363,-1
335,1,STEP,805801884305,805804606072,2721767,-1
336,1,STEP,805804691171,805807739234,3048063,-1
337,1,STEP,805807829833,805810738997,2909164,-1
338,1,STEP,805810846596,805815412040,4565444,-1
339,1,STEP,805815541739,805819827987,4286248,-1
340,1,STEP,805819929685,805823289844,3360159,-1
341,1,STEP,805823390643,805826924900,3534257,-1
342,1,STEP,805827077298,805830486157,3408859,-1
343,1,STEP,805830629555,805834481808,3852253,-1
344,1,STEP,805834602006,805837962865,3360859,-1
345,1,STEP,805838081364,805840996229,2914865,-1
346,1,STEP,805841104727,805844185690,3080963,-1
347,1,STEP,805844294588,805847467550,3172962,-1
348,1,STEP,805847550749,805851151205,3600456,-1
349,1,STEP,805851231604,805854537563,3305959,-1
350,1,STEP,805854624462,805857666725,3042263,-1
351,1,STEP,805857749824,805860798187,3048363,-1
352,1,STEP,805860880386,805864189946,3309560,-1
353,1,STEP,805864309944,805867550805,3240861,-1
354,1,STEP,805867642404,805870709266,3066862,-1
355,1,STEP,805870833665,805875494608,4660943,-1
356,1,STEP,805875627106,805879099064,3471958,-1
357,1,STEP,805879223563,805883017416,3793853,-1
358,1,STEP,805883107615,805886650272,3542657,-1
359,1,STEP,805886737971,805890169129,3431158,-1
360,1,STEP,805890282228,805893924483,3642255,-1
361,1,STEP,805894013682,805897529239,3515557,-1
362,1,STEP,805897628638,805900786400,3157762,-1
363,1,STEP,805900879999,805903926561,3046562,-1
364,1,STEP,805904016160,805907015324,2999164,-1
365,1,STEP,805907104523,805910720279,3615756,-1
366,1,STEP,805910815377,805915653018,4837641,-1
367,1,STEP,805915750617,805918712081,2961464,-1
368,1,STEP,805918803280,805921604046,2800766,-1
369,1,STEP,805921688145,805925233802,3545657,-1
370,1,STEP,805925326801,805927926069,2599268,-1
371,1,STEP,805928020868,805931183229,3162361,-1
372,1,STEP,805931274628,805934464289,3189661,-1
373,1,STEP,805934549788,805937358354,2808566,-1
374,1,STEP,805937447453,805940498416,3050963,-1
375,1,STEP,805940582715,805944429868,3847153,-1
376,1,STEP,805944541166,805947985924,3444758,-1
377,1,STEP,805948098523,805952223273,4124750,-1
378,1,STEP,805952373371,805956685518,4312147,-1
379,1,STEP,805956809317,805961024765,4215448,-1
380,1,STEP,805961141964,805964355825,3213861,-1
381,1,STEP,805964465723,805967309489,2843766,-1
382,1,STEP,805967393588,805971342940,3949352,-1
383,1,STEP,805971414639,805974924496,3509857,-1
384,1,STEP,805975044195,805978963447,3919252,-1
385,1,STEP,805979052446,805982550703,3498257,-1
386,1,STEP,805982634402,805986554554,3920152,-1
387,1,STEP,805986670453,805990006412,3335959,-1
388,1,STEP,805990083111,805994002563,3919452,-1
389,1,STEP,805994118262,805998024414,3906152,-1
390,1,STEP,805998149813,806002428861,4279048,-1
391,1,STEP,806002517660,806006156015,3638355,-1
392,1,STEP,806006267814,806009783071,3515257,-1
393,1,STEP,806009915769,806013551125,3635356,-1
394,1,STEP,806013665924,806017176881,3510957,-1
395,1,STEP,806017289180,806020711538,3422358,-1
396,1,STEP,806020842436,806023992098,3149662,-1
397,1,STEP,806024080897,806026963662,2882765,-1
398,1,STEP,806027046161,806030847114,3800953,-1
399,1,STEP,806030948413,806035177762,4229349,-1
400,1,STEP,806035268560,806038950716,3682156,-1
401,1,STEP,806039088914,806043220263,4131349,-1
402,1,STEP,806043305462,806046596522,3291060,-1
403,1,STEP,806046729421,806050000081,3270660,-1
404,1,STEP,806050076480,806053187542,3111062,-1
405,1,STEP,806053278941,806057142094,3863153,-1
406,1,STEP,806057274692,806060933048,3658356,-1
407,1,STEP,806061029546,806064805700,3776154,-1
408,1,STEP,806064931999,806069061248,4129249,-1
409,1,STEP,806069179647,806073155499,3975852,-1
410,1,STEP,806073237798,806076438659,3200861,-1
411,1,STEP,806076548057,806080272012,3723955,-1
412,1,STEP,806080375011,806083665070,3290059,-1
413,1,STEP,806083776769,806088364913,4588144,-1
414,1,STEP,806088491012,806092404764,3913752,-1
415,1,STEP,806092524662,806095653124,3128462,-1
416,1,STEP,806095764823,806099174581,3409758,-1
417,1,STEP,806099291380,806102921936,3630556,-1
418,1,STEP,806103054534,806107818876,4764342,-1
419,1,STEP,806107955074,806112730216,4775142,-1
420,1,STEP,806112865915,806117145462,4279547,-1
421,1,STEP,806117283361,806121729406,4446045,-1
422,1,STEP,806121825105,806126901243,5076138,-1
423,1,STEP,806127008442,806131137192,4128750,-1
424,1,STEP,806131235091,806134467951,3232860,-1
425,1,STEP,806134547950,806137818910,3270960,-1
426,1,STEP,806137908809,806141260368,3351559,-1
427,1,STEP,806141339667,806144000035,2660368,-1
428,1,STEP,806144073634,806147697390,3623756,-1
429,1,STEP,806147771089,806150958250,3187161,-1
430,1,STEP,806151045949,806154024213,2978264,-1
431,1,STEP,806154096912,806157196174,3099262,-1
432,1,STEP,806157305773,806160130838,2825065,-1
433,1,STEP,806160236737,806163820893,3584156,-1
434,1,STEP,806163929792,806166709458,2779666,-1
435,1,STEP,806166821757,806170198616,3376859,-1
436,1,STEP,806170309914,806173272678,2962764,-1
437,1,STEP,806173387477,806176509639,3122162,-1
438,1,STEP,806176596538,806180038896,3442358,-1
439,1,STEP,806180124195,806183295756,3171561,-1
440,1,STEP,806183378855,806186450318,3071463,-1
441,1,STEP,806186532117,806189215084,2682967,-1
442,1,STEP,806189298983,806192604543,3305560,-1
443,1,STEP,806192689142,806196445596,3756454,-1
444,1,STEP,806196527695,806199807655,3279960,-1
445,1,STEP,806199889654,806202470722,2581068,-1
446,1,STEP,806202556021,806206000679,3444658,-1
447,1,STEP,806206082378,806208920744,2838366,-1
448,1,STEP,806209001543,806211999506,2997963,-1
449,1,STEP,806212082105,806215003170,2921065,-1
450,1,STEP,806215085369,806217942634,2857265,-1
451,1,STEP,806218026833,806221153095,3126262,-1
452,1,STEP,806221245493,806224493154,3247661,-1
453,1,STEP,806224580153,806227741214,3161061,-1
454,1,STEP,806227826513,806231005374,3178861,-1
455,1,STEP,806231097073,806234360034,3262961,-1
456,1,STEP,806234440833,806238153687,3712854,-1
457,1,STEP,806238238386,806241410948,3172562,-1
458,1,STEP,806241493647,806244635808,3142161,-1
459,1,STEP,806244717307,806248061967,3344660,-1
460,1,STEP,806248146066,806251545324,3399258,-1
461,1,STEP,806251628823,806255032782,3403959,-1
462,1,STEP,806255157480,806258766036,3608556,-1
463,1,STEP,806258849035,806262332793,3483758,-1
464,1,STEP,806262420392,806265797750,3377358,-1
465,1,STEP,806265890249,806269495605,3605356,-1
466,1,STEP,806269566204,806273034662,3468458,-1
467,1,STEP,806273105761,806276440421,3334660,-1
468,1,STEP,806276515120,806279960278,3445158,-1
469,1,STEP,806280034877,806283795631,3760754,-1
470,1,STEP,806283888530,806287656184,3767654,-1
471,1,STEP,806287732383,806290842145,3109762,-1
472,1,STEP,806290911644,806294680398,3768754,-1
473,1,STEP,806294752897,806298184356,3431459,-1
474,1,STEP,806298257955,806301984809,3726854,-1
475,1,STEP,806302060608,806305254769,3194161,-1
476,1,STEP,806305365168,806308758527,3393359,-1
477,1,STEP,806308848226,806312637479,3789253,-1
478,1,STEP,806312723078,806316838928,4115850,-1
479,1,STEP,806316923827,806320315386,3391559,-1
480,1,STEP,806320391485,806323631945,3240460,-1
481,1,STEP,806323704945,806327160702,3455757,-1
482,1,STEP,806327238101,806329940368,2702267,-1
483,1,STEP,806330023567,806333043331,3019764,-1
484,1,STEP,806333111530,806336269391,3157861,-1
485,1,STEP,806336393690,806341404129,5010439,-1
486,1,STEP,806341481028,806344892086,3411058,-1
487,1,STEP,806344964985,806347833250,2868265,-1
488,1,STEP,806347906050,806351381307,3475257,-1
489,1,STEP,806351454206,806354960864,3506658,-1
490,1,STEP,806355032063,806357968927,2936864,-1
491,1,STEP,806358042426,806360765093,2722667,-1
492,1,STEP,806360833392,806364310150,3476758,-1
493,1,STEP,806364381749,806366994617,2612868,-1
494,1,STEP,806367067616,806369816082,2748466,-1
495,1,STEP,806369905681,806372689447,2783766,-1
496,1,STEP,806372760847,806375671011,2910164,-1
497,1,STEP,806375741310,806378741074,2999764,-1
498,1,STEP,806378824073,806383221019,4396946,-1
499,1,STEP,806383314918,806387013173,3698255,-1
500,1,STEP,806387099572,806390955125,3855553,-1
501,1,STEP,806391069123,806394084687,3015564,-1
502,1,STEP,806394195185,806397474445,3279260,-1
503,1,STEP,806397549744,806401100101,3550357,-1
504,1,STEP,806401195000,806404516659,3321659,-1
505,1,STEP,806404651558,806409350101,4698543,-1
506,1,STEP,806409485099,806413955944,4470845,-1
507,1,STEP,806414088943,806417305104,3216161,-1
508,1,STEP,806417378103,806420426766,3048663,-1
509,1,STEP,806420498865,806423410029,2911164,-1
510,1,STEP,806423483428,806426376993,2893565,-1
511,1,STEP,806426446192,806429473855,3027663,-1
512,1,STEP,806429578954,806432895014,3316060,-1
513,1,STEP,806432980212,806435867077,2886865,-1
514,1,STEP,806435951176,806439783530,3832354,-1
515,1,STEP,806439913428,806443220788,3307360,-1
516,1,STEP,806443295687,806446959042,3663355,-1
517,1,STEP,806447052941,806450373100,3320159,-1
518,1,STEP,806450454199,806454263253,3809054,-1
519,1,STEP,806454348352,806457580913,3232561,-1
520,1,STEP,806457654212,806461392366,3738154,-1
521,1,STEP,806461523365,806466873699,5350334,-1
522,1,STEP,806467002598,806471191847,4189249,-1
523,1,STEP,806471325045,806475271697,3946652,-1
524,1,STEP,806475389896,806478983152,3593256,-1
525,1,STEP,806479074251,806482969303,3895052,-1
526,1,STEP,806483052702,806486326562,3273860,-1
527,1,STEP,806486400261,806489340725,2940464,-1
528,1,STEP,806489409225,806492280890,2871665,-1
529,1,STEP,806492366089,806495781947,3415858,-1
530,1,STEP,806495864946,806499173506,3308560,-1
531,1,STEP,806499259305,806503848649,4589344,-1
532,1,STEP,806503982447,806508329694,4347247,-1
533,1,STEP,806508408893,806511626554,3217661,-1
534,1,STEP,806511699853,806514860114,3160261,-1
535,1,STEP,806514936013,806518466170,3530157,-1
536,1,STEP,806518578269,806521783730,3205461,-1
537,1,STEP,806521891429,806524651595,2760166,-1
538,1,STEP,806524723494,806528630047,3906553,-1
539,1,STEP,806528716146,806531408913,2692767,-1
540,1,STEP,806531480112,806534710572,3230460,-1
541,1,STEP,806534805971,806538567425,3761454,-1
542,1,STEP,806538683624,806541332692,2649068,-1
543,1,STEP,806541413191,806544813649,3400458,-1
544,1,STEP,806544922948,806548159009,3236061,-1
545,1,STEP,806548270107,806551984162,3714055,-1
546,1,STEP,806552096661,806554935726,2839065,-1
547,1,STEP,806555062124,806558502982,3440858,-1
548,1,STEP,806558616581,806562713131,4096550,-1
549,1,STEP,806562825630,806566073590,3247960,-1
550,1,STEP,806566183689,806569546648,3362959,-1
551,1,STEP,806569662146,806573452700,3790554,-1
552,1,STEP,806573569399,806577742748,4173349,-1
553,1,STEP,806577882946,806582851986,4969040,-1
554,1,STEP,806582986484,806588173621,5187137,-1
555,1,STEP,806588301919,806593164560,4862641,-1
556,1,STEP,806593293358,806597789404,4496046,-1
557,1,STEP,806597936202,806602318948,4382746,-1
558,1,STEP,806602450047,806607751782,5301735,-1
559,1,STEP,806607883780,806612408025,4524245,-1
560,1,STEP,806612540924,806616710373,4169449,-1
561,1,STEP,806616843471,806620919322,4075851,-1
562,1,STEP,806621050920,806625234769,4183849,-1
563,1,STEP,806625366967,806630401906,5034939,-1
564,1,STEP,806630529504,806635544443,5014939,-1
565,1,STEP,806635664242,806640012589,4348347,-1
566,1,STEP,806640117988,806644305937,4187949,-1
567,1,STEP,806644414135,806648966280,4552145,-1
568,1,STEP,806649089978,806653007530,3917552,-1
569,1,STEP,806653135429,806657483376,4347947,-1
570,1,STEP,806657578175,806662353517,4775342,-1
571,1,STEP,806662474415,806667695051,5220636,-1
572,1,STEP,806667826050,806670894612,3068562,-1
573,1,STEP,806671016111,806674170672,3154561,-1
574,1,STEP,806674293671,806677532232,3238561,-1
575,1,STEP,806677617530,806680770392,3152862,-1
576,1,STEP,806680890691,806683886754,2996063,-1
577,1,STEP,806683977153,806687312912,3335759,-1
578,1,STEP,806687402111,806690725471,3323360,-1
579,1,STEP,806690813670,806694120129,3306459,-1
580,1,STEP,806694200628,806697203592,3002964,-1
581,1,STEP,806697276191,806700066757,2790566,-1
582,1,STEP,806700145356,806703514015,3368659,-1
583,1,STEP,806703595814,806706337180,2741366,-1
584,1,STEP,806706420579,806709383443,2962864,-1
585,1,STEP,806709464342,806712537605,3073263,-1
586,1,STEP,806712619004,806716090162,3471158,-1
587,1,STEP,806716176060,806719443921,3267861,-1
588,1,STEP,806719530520,806723004977,3474457,-1
589,1,STEP,806723087176,806726061740,2974564,-1
590,1,STEP,806726145739,806729339800,3194061,-1
591,1,STEP,806729420899,806732627760,3206861,-1
592,1,STEP,806732711259,806736385614,3674355,-1
593,1,STEP,806736472413,806739469077,2996664,-1
594,1,STEP,806739556775,806742238943,2682168,-1
595,1,STEP,806742331542,806745251806,2920264,-1
596,1,STEP,806745338305,806748003672,2665367,-1
597,1,STEP,806748089471,806750943237,2853766,-1
598,1,STEP,806751045935,806753793902,2747967,-1
599,1,STEP,806753885701,806757237860,3352159,-1
600,1,STEP,806757324259,806760608019,3283760,-1
601,1,STEP,806760697218,806764012977,3315759,-1
602,1,STEP,806764101276,806767161539,3060263,-1
603,1,STEP,806767249738,806770519198,3269460,-1
604,1,STEP,806770610397,806773522661,2912264,-1
605,1,STEP,806773608660,806777156417,3547757,-1
606,1,STEP,806777241416,806780178680,2937264,-1
607,1,STEP,806780264679,806783396641,3131962,-1
608,1,STEP,806783485740,806786554203,3068463,-1
609,1,STEP,806786647601,806789716864,3069263,-1
610,1,STEP,806789803163,806792904925,3101762,-1
611,1,STEP,806792990024,806795630692,2640668,-1
612,1,STEP,806795712691,806798562856,2850165,-1
613,1,STEP,806798645355,806801315423,2670068,-1
614,1,STEP,806801392722,806804695181,3302459,-1
615,1,STEP,806804779180,806807753344,2974164,-1
616,1,STEP,806807836843,806810631009,2794166,-1
617,1,STEP,806810712308,806813308776,2596468,-1
618,1,STEP,806813394275,806816460038,3065763,-1
619,1,STEP,806816541537,806819665699,3124162,-1
620,1,STEP,806819748898,806822826660,3077762,-1
621,1,STEP,806822912659,806825744525,2831866,-1
622,1,STEP,806825824324,806828717889,2893565,-1
623,1,STEP,806828799688,806831881650,3081962,-1
624,1,STEP,806831971849,806835361108,3389259,-1
625,1,STEP,806835443707,806838779666,3335959,-1
626,1,STEP,806838870065,806841852329,2982264,-1
627,1,STEP,806841951627,806845242987,3291360,-1
628,1,STEP,806845332686,806848633446,3300760,-1
629,1,STEP,806848717545,806851745208,3027663,-1
630,1,STEP,806851828507,806855450163,3621656,-1
631,1,STEP,806855525862,806858437426,2911564,-1
632,1,STEP,806858511125,806861569288,3058163,-1
633,1,STEP,806861640687,806864750949,3110262,-1
634,1,STEP,806864835648,806867893811,3058163,-1
635,1,STEP,806867980610,806870900174,2919564,-1
636,1,STEP,806870992973,806873564342,2571369,-1
637,1,STEP,806873651041,806877143898,3492857,-1
638,1,STEP,806877223297,806880433458,3210161,-1
639,1,STEP,806880520657,806883316523,2795866,-1
640,1,STEP,806883398822,806886553484,3154662,-1
641,1,STEP,806886644183,806889705845,3061662,-1
642,1,STEP,806889791944,806893047304,3255360,-1
643,1,STEP,806893166803,806896203966,3037163,-1
644,1,STEP,806896319465,806899557525,3238060,-1
645,1,STEP,806899670924,806902761286,3090362,-1
646,1,STEP,806902876085,806905930747,3054662,-1
647,1,STEP,806906044846,806909570803,3525957,-1
648,1,STEP,806909685202,806912802164,3116962,-1
649,1,STEP,806912916962,806916569318,3652356,-1
650,1,STEP,806916685616,806919645180,2959564,-1
651,1,STEP,806919759879,806922500745,2740866,-1
652,1,STEP,806922617044,806925826205,3209161,-1
653,1,STEP,806925951003,806928767769,2816766,-1
654,1,STEP,806928880168,806932060529,3180361,-1
655,1,STEP,806932174228,806935482287,3308059,-1
656,1,STEP,806935597386,806938705448,3108062,-1
657,1,STEP,806938818347,806941877009,3058662,-1
658,1,STEP,806941990108,806944681275,2691167,-1
659,1,STEP,806944793174,806948218432,3425258,-1
660,1,STEP,806948335131,806951767289,3432158,-1
661,1,STEP,806951881487,806955276646,3395159,-1
662,1,STEP,806955393345,806958514106,3120761,-1
663,1,STEP,806958626505,806961970064,3343559,-1
664,1,STEP,806962090063,806965152926,3062863,-1
665,1,STEP,806965268024,806968781081,3513057,-1
666,1,STEP,806968895380,806972052441,3157061,-1
667,1,STEP,806972165640,806975270102,3104462,-1
668,1,STEP,806975384701,806978194667,2809966,-1
669,1,STEP,806978309065,806980889034,2579969,-1
670,1,STEP,806981001932,806984821786,3819854,-1
671,1,STEP,806984938284,806988361143,3422859,-1
672,1,STEP,806988480041,806991784801,3304760,-1
673,1,STEP,806991875200,806994700365,2825165,-1
674,1,STEP,806994780164,806997662729,2882565,-1
675,1,STEP,806997743328,807000952489,3209161,-1
676,1,STEP,807001034988,807003838054,2803066,-1
677,1,STEP,807003950753,807009108390,5157637,-1
678,1,STEP,807009246888,807013340638,4093750,-1
679,1,STEP,807013463937,807017209891,3745954,-1
680,1,STEP,807017286390,807020754548,3468158,-1
681,1,STEP,807020830447,807024043708,3213261,-1
682,1,STEP,807024117507,807027571265,3453758,-1
683,1,STEP,807027647864,807030892424,3244560,-1
684,1,STEP,807030966123,807034009986,3043863,-1
685,1,STEP,807034082985,807037482044,3399059,-1
686,1,STEP,807037553643,807040370909,2817266,-1
687,1,STEP,807040442508,807044090563,3648055,-1
688,1,STEP,807044197362,807047298224,3100862,-1
689,1,STEP,807047394623,807051221476,3826853,-1
690,1,STEP,807051346375,807054259739,2913364,-1
691,1,STEP,807054373538,807057481300,3107762,-1
692,1,STEP,807057598799,807061522451,3923652,-1
693,1,STEP,807061640549,807064346316,2705767,-1
694,1,STEP,807064456915,807067267781,2810866,-1
695,1,STEP,807067377879,807070163146,2785267,-1
696,1,STEP,807070272744,807072802513,2529769,-1
697,1,STEP,807072907712,807075634879,2727167,-1
698,1,STEP,807075731378,807078766341,3034963,-1
699,1,STEP,807078848440,807081996301,3147861,-1
700,1,STEP,807082077700,807085174663,3096963,-1
701,1,STEP,807085255662,807088425223,3169561,-1
702,1,STEP,807088508322,807092061579,3553257,-1
703,1,STEP,807092156277,807094819745,2663468,-1
704,1,STEP,807094906444,807097913507,3007063,-1
705,1,STEP,807097998106,807100537775,2539669,-1
706,1,STEP,807100616374,807103142044,2525670,-1
707,1,STEP,807103226742,807106307805,3081063,-1
708,1,STEP,807106399704,807109410767,3011063,-1
709,1,STEP,807109501366,807112587628,3086262,-1
710,1,STEP,807112677927,807115872288,3194361,-1
711,1,STEP,807115959787,807118821752,2861965,-1
712,1,STEP,807118917551,807122320710,3403159,-1
713,1,STEP,807122433008,807126381760,3948752,-1
714,1,STEP,807126475959,807129485622,3009663,-1
715,1,STEP,807129585121,807133112778,3527657,-1
716,1,STEP,807133203177,807136421238,3218061,-1
717,1,STEP,807136513637,807139418401,2904764,-1
718,1,STEP,807139510400,807142338266,2827866,-1
719,1,STEP,807142426765,807145619726,3192961,-1
720,1,STEP,807145709525,807149211982,3502457,-1
721,1,STEP,807149298081,807152357244,3059163,-1
722,1,STEP,807152448043,807156133398,3685355,-1
723,1,STEP,807156220297,807159347658,3127361,-1
724,1,STEP,807159433157,807163018514,3585357,-1
725,1,STEP,807163108713,807166555071,3446358,-1
726,1,STEP,807166646569,807169823231,3176662,-1
727,1,STEP,807169920530,807173243389,3322859,-1
728,1,STEP,807173328388,807176509949,3181561,-1
729,1,STEP,807176596748,807180173205,3576457,-1
730,1,STEP,807180262203,807184092957,3830754,-1
731,1,STEP,807184181956,807187463316,3281360,-1
732,1,STEP,807187551315,807190472679,2921364,-1
733,1,STEP,807190594678,807193567541,2972863,-1
734,1,STEP,807193641940,807196303708,2661768,-1
735,1,STEP,807196378607,807199085074,2706467,-1
736,1,STEP,807199159073,807202192836,3033763,-1
737,1,STEP,807202265435,807204986302,2720867,-1
738,1,STEP,807205059401,807207940966,2881565,-1
739,1,STEP,807208014965,807211238726,3223761,-1
740,1,STEP,807211312525,807214087791,2775266,-1
741,1,STEP,807214160390,807216906357,2745967,-1
742,1,STEP,807216979256,807220138817,3159561,-1
743,1,STEP,807220211217,807223867972,3656755,-1
744,1,STEP,807223941571,807226976734,3035163,-1
745,1,STEP,807227050333,807230413192,3362859,-1
746,1,STEP,807230487391,807233663753,3176362,-1
747,1,STEP,807233736352,807236394519,2658167,-1
748,1,STEP,807236467718,807239709579,3241861,-1
749,1,STEP,807239783978,807242299747,2515769,-1
750,1,STEP,807242373346,807245618507,3245161,-1
751,1,STEP,807245690906,807248964166,3273260,-1
752,1,STEP,807249038565,807252100328,3061763,-1
753,1,STEP,807252174127,807254799895,2625768,-1
754,1,STEP,807254874594,807258265753,3391159,-1
755,1,STEP,807258340152,807261142118,2801966,-1
756,1,STEP,807261215017,807264328779,3113762,-1
757,1,STEP,807264402978,807267227543,2824565,-1
758,1,STEP,807267300643,807270574203,3273560,-1
759,1,STEP,807270647702,807273903862,3256160,-1
760,1,STEP,807273977361,807276596829,2619468,-1
761,1,STEP,807276667928,807280188185,3520257,-1
762,1,STEP,807280315484,807284076138,3760654,-1
763,1,STEP,807284152037,807287084101,2932064,-1
764,1,STEP,807287157700,807289960366,2802666,-1
765,1,STEP,807290036165,807293302026,3265861,-1
766,1,STEP,807293376325,807296509686,3133361,-1
767,1,STEP,807296583486,807299978044,3394558,-1
768,1,STEP,807300068643,807302903809,2835166,-1
769,1,STEP,807302976308,807305459477,2483169,-1
770,1,STEP,807305529777,807308895135,3365358,-1
771,1,STEP,807308969035,807312110296,3141261,-1
772,1,STEP,807312182595,807315149959,2967364,-1
773,1,STEP,807315224658,807318775915,3551257,-1
774,1,STEP,807318850614,807321693579,2842965,-1
775,1,STEP,807321765679,807324807842,3042163,-1
776,1,STEP,807324880541,807328201900,3321359,-1
777,1,STEP,807328274599,807331159364,2884765,-1
778,1,STEP,807331232963,807334267726,3034763,-1
779,1,STEP,807334342125,807337545686,3203561,-1
780,1,STEP,807337619885,807340274953,2655068,-1
781,1,STEP,807340348852,807342736523,2387671,-1
782,1,STEP,807342809022,807345940784,3131762,-1
783,1,STEP,807346061782,807349155145,3093363,-1
784,1,STEP,807349229544,807352076009,2846465,-1
785,1,STEP,807352151008,807355364869,3213861,-1
786,1,STEP,807355439868,807358610529,3170661,-1
787,1,STEP,807358683929,807361378996,2695067,-1
788,1,STEP,807361451195,807364852253,3401058,-1
789,1,STEP,807364927952,807368200013,3272061,-1
790,1,STEP,807368274312,807371798369,3524057,-1
791,1,STEP,807371871968,807375124128,3252160,-1
792,1,STEP,807375198327,807378574286,3375959,-1
793,1,STEP,807378650485,807381945545,3295060,-1
794,1,STEP,807382022044,807385561401,3539357,-1
795,1,STEP,807385635900,807388910760,3274860,-1
796,1,STEP,807388985459,807392470917,3485458,-1
797,1,STEP,807392546016,807395276383,2730367,-1
798,1,STEP,807395349982,807398659941,3309959,-1
799,1,STEP,807398732140,807401709804,2977664,-1
800,1,STEP,807401783903,807404695268,2911365,-1
801,1,STEP,807404767367,807408202725,3435358,-1
802,1,STEP,807408275724,807410853493,2577769,-1
803,1,STEP,807410926392,807414660546,3734154,-1
804,1,STEP,807414734045,807418351201,3617156,-1
805,1,STEP,807418426100,807421173967,2747867,-1
806,1,STEP,807421245866,807424522526,3276660,-1
807,1,STEP,807424594925,807427742987,3148062,-1
808,1,STEP,807427816486,807430612352,2795866,-1
809,1,STEP,807430686251,807433627215,2940964,-1
810,1,STEP,807433701914,807436432381,2730467,-1
811,1,STEP,807436506380,807439667141,3160761,-1
812,1,STEP,807439742541,807443072300,3329759,-1
813,1,STEP,807443150399,807446175862,3025463,-1
814,1,STEP,807446249461,807449174926,2925465,-1
815,1,STEP,807449247725,807453036578,3788853,-1
816,1,STEP,807453115278,807456859332,3744054,-1
817,1,STEP,807456934331,807460269490,3335159,-1
818,1,STEP,807460343889,807463492851,3148962,-1
819,1,STEP,807463566850,807466665212,3098362,-1
820,1,STEP,807466738911,807469549077,2810166,-1
821,1,STEP,807469620976,807472691239,3070263,-1
822,1,STEP,807472766738,807475599903,2833165,-1
823,1,STEP,807475673403,807478896463,3223060,-1
824,1,STEP,807478971562,807481499332,2527770,-1
825,1,STEP,807481571331,807484367697,2796366,-1
826,1,STEP,807484441596,807487897554,3455958,-1
827,1,STEP,807487971653,807491015516,3043863,-1
828,1,STEP,807491091615,807493943980,2852365,-1
829,1,STEP,807494018579,807496941343,2922764,-1
830,1,STEP,807497013942,807499722609,2708667,-1
831,1,STEP,807499795109,807502582075,2786966,-1
832,1,STEP,807502652774,807505732936,3080162,-1
833,1,STEP,807505805135,807508447803,2642668,-1
834,1,STEP,807508519502,807511582465,3062963,-1
835,1,STEP,807511654664,807514645327,2990663,-1
836,1,STEP,807514718427,807518260683,3542256,-1
837,1,STEP,807518333783,807521305146,2971363,-1
838,1,STEP,807521378645,807524125112,2746467,-1
839,1,STEP,807524198711,807526873278,2674567,-1
840,1,STEP,807526947378,807529852142,2904764,-1
841,1,STEP,807529945041,807532884105,2939064,-1
842,1,STEP,807532956404,807536219265,3262861,-1
843,1,STEP,807536349463,807540394014,4044551,-1
844,1,STEP,807540465213,807543645274,3180061,-1
845,1,STEP,807543718073,807546919534,3201461,-1
846,1,STEP,807546990733,807550911285,3920552,-1
847,1,STEP,807551037984,807554577641,3539657,-1
848,1,STEP,807554652240,807557924900,3272660,-1
849,1,STEP,807557998799,807561548256,3549457,-1
850,1,STEP,807561621055,807564391221,2770166,-1
851,1,STEP,807564463220,807567744380,3281160,-1
852,1,STEP,807567817679,807571473035,3655356,-1
853,1,STEP,807571546034,807574777195,3231161,-1
854,1,STEP,807574856194,807577614960,2758766,-1
855,1,STEP,807577686359,807580643023,2956664,-1
856,1,STEP,807580716622,807583585087,2868465,-1
857,1,STEP,807583658686,807586744549,3085863,-1
858,1,STEP,807586817148,807590243306,3426158,-1
859,1,STEP,807590316805,807593588765,3271960,-1
860,1,STEP,807593659864,807596853525,3193661,-1
861,1,STEP,807596925225,807600080486,3155261,-1
862,1,STEP,807600152585,807603544944,3392359,-1
863,1,STEP,807603618943,807606990402,3371459,-1
864,1,STEP,807607064001,807610240262,3176261,-1
865,1,STEP,807610313261,807613453223,3139962,-1
866,1,STEP,807613525022,807616303488,2778466,-1
867,1,STEP,807616373587,807619532749,3159162,-1
868,1,STEP,807619605248,807622645611,3040363,-1
869,1,STEP,807622717010,807626144968,3427958,-1
870,1,STEP,807626218067,807629267030,3048963,-1
871,1,STEP,807629337429,807632085996,2748567,-1
872,1,STEP,807632155195,807635314357,3159162,-1
873,1,STEP,807635384156,807638378019,2993863,-1
874,1,STEP,807638450318,807641194185,2743867,-1
875,1,STEP,807641263484,807644408846,3145362,-1
876,1,STEP,807644480445,807647400409,2919964,-1
877,1,STEP,807647469708,807650285274,2815566,-1
878,1,STEP,807650356373,807653686533,3330160,-1
879,1,STEP,807653758232,807656658096,2899864,-1
880,1,STEP,807656731396,807660144954,3413558,-1
881,1,STEP,807660218053,807662914920,2696867,-1
882,1,STEP,807662982219,807665531588,2549369,-1
883,1,STEP,807665599187,807668369754,2770567,-1
884,1,STEP,807668440053,807671111020,2670967,-1
885,1,STEP,807671182919,807674576778,3393859,-1
886,1,STEP,807674649977,807677517642,2867665,-1
887,1,STEP,807677588241,807680644204,3055963,-1
888,1,STEP,807680716403,807683408770,2692367,-1
889,1,STEP,807683480969,807686771129,3290160,-1
890,1,STEP,807686844728,807689819192,2974464,-1
891,1,STEP,807689898691,807693243050,3344359,-1
892,1,STEP,807693315350,807696347313,3031963,-1
893,1,STEP,807696419812,807698797783,2377971,-1
894,1,STEP,807698868882,807701789346,2920464,-1
895,1,STEP,807701889745,807704563612,2673867,-1
896,1,STEP,807704635412,807707781573,3146161,-1
897,1,STEP,807707850372,807711089033,3238661,-1
898,1,STEP,807711160432,807713813300,2652868,-1
899,1,STEP,807713905699,807717387456,3481757,-1
900,1,STEP,807717457855,807720047024,2589169,-1
901,1,STEP,807720114423,807723215285,3100862,-1
902,1,STEP,807723284884,807726137749,2852865,-1
903,1,STEP,807726207349,807729262511,3055162,-1
904,1,STEP,807729333011,807732541471,3208460,-1
905,1,STEP,807732612271,807735467536,2855265,-1
906,1,STEP,807735538935,807738464899,2925964,-1
907,1,STEP,807738536398,807741716460,3180062,-1
908,1,STEP,807741785959,807744539425,2753466,-1
909,1,STEP,807744609224,807747226792,2617568,-1
910,1,STEP,807747297092,807749965059,2667967,-1
911,1,STEP,807750034358,807753447917,3413559,-1
912,1,STEP,807753517616,807755949786,2432170,-1
913,1,STEP,807756019085,807759054648,3035563,-1
914,1,STEP,807759126747,807762173710,3046963,-1
915,1,STEP,807762243909,807765289672,3045763,-1
916,1,STEP,807765358771,807767923340,2564569,-1
917,1,STEP,807767994339,807770419810,2425471,-1
918,1,STEP,807770488009,807773481872,2993863,-1
919,1,STEP,807773551072,807776810432,3259360,-1
920,1,STEP,807776882931,807780082992,3200061,-1
921,1,STEP,807780153691,807783486850,3333159,-1
922,1,STEP,807783560650,807786235117,2674467,-1
923,1,STEP,807786304516,807789534877,3230361,-1
924,1,STEP,807789605476,807792159045,2553569,-1
925,1,STEP,807792227844,807795491504,3263660,-1
926,1,STEP,807795564103,807798622966,3058863,-1
927,1,STEP,807798693865,807801231334,2537469,-1
928,1,STEP,807801300233,807804103599,2803366,-1
929,1,STEP,807804175498,807807212561,3037063,-1
930,1,STEP,807807282960,807810119626,2836666,-1
931,1,STEP,807810190925,807812827993,2637068,-1
932,1,STEP,807812896392,807816335250,3438858,-1
933,1,STEP,807816404249,807819541811,3137562,-1
934,1,STEP,807819614610,807822844471,3229861,-1
935,1,STEP,807822918070,807826488226,3570156,-1
936,1,STEP,807826560425,807830229681,3669256,-1
937,1,STEP,807830303080,807833086146,2783066,-1
938,1,STEP,807833154845,807836484704,3329859,-1
939,1,STEP,807836566503,807839170972,2604469,-1
940,1,STEP,807839240771,807842319033,3078262,-1
941,1,STEP,807842390932,807845211998,2821066,-1
942,1,STEP,807845281897,807848015064,2733167,-1
943,1,STEP,807848084663,807850904829,2820166,-1
944,1,STEP,807850971628,807853988591,3016963,-1
945,1,STEP,807854060090,807857296251,3236161,-1
946,1,STEP,807857367450,807860810608,3443158,-1
947,1,STEP,807860883907,807863904970,3021063,-1
948,1,STEP,807863976269,807866271541,2295272,-1
949,1,STEP,807866340040,807869927897,3587857,-1
950,1,STEP,807869996496,807873331655,3335159,-1
951,1,STEP,807873403754,807876387418,2983664,-1
952,1,STEP,807876459117,807879825276,3366159,-1
953,1,STEP,807879897775,807882271446,2373671,-1
954,1,STEP,807882342245,807885571406,3229161,-1
955,1,STEP,807885644305,807888455671,2811366,-1
956,1,STEP,807888525270,807892127826,3602556,-1
957,1,STEP,807892200525,807895311887,3111362,-1
958,1,STEP,807895383786,807898355750,2971964,-1
959,1,STEP,807898427649,807901271315,2843666,-1
960,1,STEP,807901337414,807904423676,3086262,-1
961,1,STEP,807904495775,807907870334,3374559,-1
962,1,STEP,807907944233,807911160694,3216461,-1
963,1,STEP,807911234393,807914089158,2854765,-1
964,1,STEP,807914161558,807917204920,3043362,-1
965,1,STEP,807917276120,807920714978,3438858,-1
966,1,STEP,807920787977,807923823440,3035463,-1
967,1,STEP,807923917039,807926722304,2805265,-1
968,1,STEP,807926794904,807929785167,2990263,-1
969,1,STEP,807929856966,807932368636,2511670,-1
970,1,STEP,807932439235,807935077803,2638568,-1
971,1,STEP,807935150402,807938038567,2888165,-1
972,1,STEP,807938111166,807941067230,2956064,-1
973,1,STEP,807941138529,807943984994,2846465,-1
974,1,STEP,807944057493,807947015357,2957864,-1
975,1,STEP,807947088456,807950105519,3017063,-1
976,1,STEP,807950179919,807953301880,3121961,-1
977,1,STEP,807953373280,807956056047,2682767,-1
978,1,STEP,807956127546,807959228308,3100762,-1
979,1,STEP,807959302007,807962412369,3110362,-1
980,1,STEP,807962485569,807965544531,3058962,-1
981,1,STEP,807965616130,807968340397,2724267,-1
982,1,STEP,807968413196,807971416560,3003364,-1
983,1,STEP,807971490259,807974598221,3107962,-1
984,1,STEP,807974672320,807977397387,2725067,-1
985,1,STEP,807977469386,807980290051,2820665,-1
986,1,STEP,807980361451,807982936119,2574668,-1
987,1,STEP,807983007918,807986199879,3191961,-1
988,1,STEP,807986271579,807989267542,2995963,-1
989,1,STEP,807989338341,807992225506,2887165,-1
990,1,STEP,807992296305,807994761475,2465170,-1
991,1,STEP,807994831574,807997738939,2907365,-1
992,1,STEP,807997808338,808000653103,2844765,-1
993,1,STEP,808000725302,808003621767,2896465,-1
994,1,STEP,808003691866,808006343134,2651268,-1
995,1,STEP,808006413633,808009848791,3435158,-1
996,1,STEP,808009940590,808012961453,3020863,-1
997,1,STEP,808013070052,808016169314,3099262,-1
998,1,STEP,808016279413,808019313276,3033863,-1
999,1,STEP,808019420475,808022514537,3094062,-1
