Gen,Resource,Stamp,TimeStamp_Start,TimeStamp_End,Duration,Indiv_id
0,1,FirstEvaluation,897607675446,898432504698,824829252,-1
0,1,STEP,898432690696,898438661732,5971036,-1
1,1,STEP,898438773131,898443343083,4569952,-1
2,1,STEP,898443451482,898448402629,4951147,-1
3,1,STEP,898448511928,898452694883,4182955,-1
4,1,STEP,898452804582,898456293045,3488463,-1
5,1,STEP,898456402844,898460989496,4586652,-1
6,1,STEP,898461101894,898465463748,4361854,-1
7,1,STEP,898465580247,898469771402,4191155,-1
8,1,STEP,898469891201,898473538262,3647061,-1
9,1,STEP,898473647061,898478538609,4891548,-1
10,1,STEP,898478650108,898482262870,3612762,-1
11,1,STEP,898482370069,898487106519,4736450,-1
12,1,STEP,898487215417,898492134865,4919448,-1
13,1,STEP,898492244664,898496446519,4201855,-1
14,1,STEP,898496558418,898500836473,4278055,-1
15,1,STEP,898500946672,898504238237,3291565,-1
16,1,STEP,898504347636,898508559891,4212255,-1
17,1,STEP,898508670090,898512743347,4073257,-1
18,1,STEP,898512852045,898516411308,3559263,-1
19,1,STEP,898516525106,898519572274,3047168,-1
20,1,STEP,898519681273,898523876228,4194955,-1
21,1,STEP,898523993227,898527520490,3527263,-1
22,1,STEP,898527587089,898530559858,2972769,-1
23,1,STEP,898530624557,898534484016,3859459,-1
24,1,STEP,898534550415,898538720071,4169656,-1
25,1,STEP,898538788170,898542748228,3960058,-1
26,1,STEP,898542815528,898546944084,4128556,-1
27,1,STEP,898547009883,898551048240,4038357,-1
28,1,STEP,898551114840,898554599803,3484963,-1
29,1,STEP,898554665002,898559345452,4680450,-1
30,1,STEP,898559415052,898563037113,3622061,-1
31,1,STEP,898563103412,898566764774,3661362,-1
32,1,STEP,898566840873,898570596133,3755260,-1
33,1,STEP,898570665732,898573892198,3226466,-1
34,1,STEP,898573958197,898577389361,3431164,-1
35,1,STEP,898577455760,898580668226,3212466,-1
36,1,STEP,898580735225,898584129989,3394764,-1
37,1,STEP,898584195889,898587189757,2993868,-1
38,1,STEP,898587254556,898589995727,2741171,-1
39,1,STEP,898590060827,898593022295,2961468,-1
40,1,STEP,898593086694,898596348160,3261466,-1
41,1,STEP,898596414859,898599741324,3326465,-1
42,1,STEP,898599844823,898604443774,4598951,-1
43,1,STEP,898604553773,898607926637,3372864,-1
44,1,STEP,898608005836,898611149203,3143367,-1
45,1,STEP,898611232602,898614932463,3699861,-1
46,1,STEP,898615021362,898618395426,3374064,-1
47,1,STEP,898618474425,898621576492,3102067,-1
48,1,STEP,898621659891,898624623360,2963469,-1
49,1,STEP,898624703259,898627486230,2782971,-1
50,1,STEP,898627566029,898630844894,3278865,-1
51,1,STEP,898630926093,898634206958,3280865,-1
52,1,STEP,898634287157,898637572023,3284866,-1
53,1,STEP,898637650422,898640519791,2869369,-1
54,1,STEP,898640597690,898643845356,3247666,-1
55,1,STEP,898643932755,898647355119,3422364,-1
56,1,STEP,898647435618,898650700983,3265365,-1
57,1,STEP,898650782082,898653490154,2708072,-1
58,1,STEP,898653567053,898656049027,2481974,-1
59,1,STEP,898656138326,898658639999,2501673,-1
60,1,STEP,898658723298,898661382170,2658872,-1
61,1,STEP,898661456369,898664632436,3176067,-1
62,1,STEP,898664710335,898667516705,2806370,-1
63,1,STEP,898667601904,898670756471,3154567,-1
64,1,STEP,898670835470,898674416832,3581362,-1
65,1,STEP,898674503731,898678057693,3553962,-1
66,1,STEP,898678138892,898680565067,2426175,-1
67,1,STEP,898680640366,898683616534,2976168,-1
68,1,STEP,898683697533,898686540903,2843370,-1
69,1,STEP,898686620802,898689226075,2605273,-1
70,1,STEP,898689304874,898691797547,2492673,-1
71,1,STEP,898691879047,898694835615,2956568,-1
72,1,STEP,898694919514,898698034381,3114867,-1
73,1,STEP,898698112980,898701438545,3325565,-1
74,1,STEP,898701519244,898704575012,3055768,-1
75,1,STEP,898704653911,898707660679,3006768,-1
76,1,STEP,898707740778,898710388650,2647872,-1
77,1,STEP,898710467449,898713279620,2812171,-1
78,1,STEP,898713358719,898716183089,2824370,-1
79,1,STEP,898716262988,898718968459,2705471,-1
80,1,STEP,898719047758,898721986427,2938669,-1
81,1,STEP,898722066326,898724681299,2614973,-1
82,1,STEP,898724760898,898727691467,2930569,-1
83,1,STEP,898727771566,898730540636,2769070,-1
84,1,STEP,898730620536,898733616704,2996168,-1
85,1,STEP,898733706803,898736497773,2790970,-1
86,1,STEP,898736577272,898739564041,2986769,-1
87,1,STEP,898739644440,898742581509,2937069,-1
88,1,STEP,898742661508,898745618777,2957269,-1
89,1,STEP,898745734975,898748589045,2854070,-1
90,1,STEP,898748671344,898751915010,3243666,-1
91,1,STEP,898751999009,898755355173,3356164,-1
92,1,STEP,898755440372,898758634339,3193967,-1
93,1,STEP,898758716638,898761232811,2516173,-1
94,1,STEP,898761317910,898764045381,2727471,-1
95,1,STEP,898764125780,898767247647,3121867,-1
96,1,STEP,898767326846,898770102617,2775771,-1
97,1,STEP,898770186616,898773006386,2819770,-1
98,1,STEP,898773086585,898775821256,2734671,-1
99,1,STEP,898775900155,898778894524,2994369,-1
100,1,STEP,898778984123,898781501896,2517773,-1
101,1,STEP,898781582195,898784587563,3005368,-1
102,1,STEP,898784685562,898787730630,3045068,-1
103,1,STEP,898787803529,898790615999,2812470,-1
104,1,STEP,898790687799,898793319571,2631772,-1
105,1,STEP,898793385570,898796653035,3267465,-1
106,1,STEP,898796724835,898799789702,3064867,-1
107,1,STEP,898799861401,898802693671,2832270,-1
108,1,STEP,898802762170,898806040036,3277866,-1
109,1,STEP,898806113735,898809054804,2941069,-1
110,1,STEP,898809123603,898812155071,3031468,-1
111,1,STEP,898812225570,898815330437,3104867,-1
112,1,STEP,898815403836,898818170307,2766471,-1
113,1,STEP,898818240106,898820873778,2633672,-1
114,1,STEP,898820942178,898823984745,3042567,-1
115,1,STEP,898824055045,898826747016,2691971,-1
116,1,STEP,898826818715,898829969382,3150667,-1
117,1,STEP,898830041881,898833109749,3067868,-1
118,1,STEP,898833179848,898836563812,3383964,-1
119,1,STEP,898836634211,898840105174,3470963,-1
120,1,STEP,898840180274,898843818035,3637761,-1
121,1,STEP,898843892034,898847173199,3281165,-1
122,1,STEP,898847245299,898850231967,2986668,-1
123,1,STEP,898850303066,898853231935,2928869,-1
124,1,STEP,898853303634,898856402602,3098968,-1
125,1,STEP,898856474901,898859203072,2728171,-1
126,1,STEP,898859272971,898862202740,2929769,-1
127,1,STEP,898862318439,898866643593,4325154,-1
128,1,STEP,898866771192,898870089856,3318664,-1
129,1,STEP,898870181155,898873170724,2989569,-1
130,1,STEP,898873263123,898876021893,2758770,-1
131,1,STEP,898876108293,898879007062,2898769,-1
132,1,STEP,898879095061,898882080229,2985168,-1
133,1,STEP,898882174628,898885136697,2962069,-1
134,1,STEP,898885226796,898888524961,3298165,-1
135,1,STEP,898888612960,898891689727,3076767,-1
136,1,STEP,898891779226,898894643296,2864070,-1
137,1,STEP,898894734195,898898301257,3567062,-1
138,1,STEP,898898389256,898901379024,2989768,-1
139,1,STEP,898901465924,898904398692,2932768,-1
140,1,STEP,898904486992,898907698357,3211365,-1
141,1,STEP,898907789656,898910982123,3192467,-1
142,1,STEP,898911074322,898914777782,3703460,-1
143,1,STEP,898914869281,898917915849,3046568,-1
144,1,STEP,898918012948,898920401423,2388475,-1
145,1,STEP,898920496022,898924191383,3695361,-1
146,1,STEP,898924287981,898927094452,2806471,-1
147,1,STEP,898927185951,898929973921,2787970,-1
148,1,STEP,898930068620,898932956290,2887670,-1
149,1,STEP,898933047289,898936425753,3378464,-1
150,1,STEP,898936514852,898939601319,3086467,-1
151,1,STEP,898939693318,898943059582,3366264,-1
152,1,STEP,898943156481,898946325648,3169167,-1
153,1,STEP,898946418547,898949096018,2677471,-1
154,1,STEP,898949186317,898952167886,2981569,-1
155,1,STEP,898952257785,898955442151,3184366,-1
156,1,STEP,898955530750,898958129723,2598973,-1
157,1,STEP,898958219322,898961285089,3065767,-1
158,1,STEP,898961375088,898964902251,3527163,-1
159,1,STEP,898964993250,898968129816,3136566,-1
160,1,STEP,898968220916,898971742878,3521962,-1
161,1,STEP,898971839677,898975022543,3182866,-1
162,1,STEP,898975114442,898978213810,3099368,-1
163,1,STEP,898978305809,898981171878,2866069,-1
164,1,STEP,898981259477,898984445143,3185666,-1
165,1,STEP,898984534442,898987533211,2998769,-1
166,1,STEP,898987625610,898990581278,2955668,-1
167,1,STEP,898990674477,898993660946,2986469,-1
168,1,STEP,898993751045,898996975311,3224266,-1
169,1,STEP,898997067310,898999905079,2837769,-1
170,1,STEP,899000000878,899002904748,2903870,-1
171,1,STEP,899003007847,899006037414,3029567,-1
172,1,STEP,899006133513,899008806485,2672972,-1
173,1,STEP,899008895084,899012038951,3143867,-1
174,1,STEP,899012135950,899015396115,3260165,-1
175,1,STEP,899015488714,899018263285,2774571,-1
176,1,STEP,899018352484,899021644949,3292465,-1
177,1,STEP,899021734048,899024846915,3112867,-1
178,1,STEP,899024942014,899027584186,2642172,-1
179,1,STEP,899027680285,899031118148,3437863,-1
180,1,STEP,899031209647,899033936519,2726872,-1
181,1,STEP,899034026218,899036725089,2698871,-1
182,1,STEP,899036813888,899039618358,2804470,-1
183,1,STEP,899039708857,899042624526,2915669,-1
184,1,STEP,899042730825,899046112689,3381864,-1
185,1,STEP,899046214188,899049460454,3246266,-1
186,1,STEP,899049558353,899052101926,2543573,-1
187,1,STEP,899052198525,899055165893,2967368,-1
188,1,STEP,899055259892,899058224961,2965069,-1
189,1,STEP,899058319360,899060875233,2555873,-1
190,1,STEP,899060969032,899063700603,2731571,-1
191,1,STEP,899063795602,899066801270,3005668,-1
192,1,STEP,899066892769,899069463942,2571173,-1
193,1,STEP,899069552541,899072491610,2939069,-1
194,1,STEP,899072579909,899075383479,2803570,-1
195,1,STEP,899075473778,899078360647,2886869,-1
196,1,STEP,899078451946,899082099808,3647862,-1
197,1,STEP,899082192907,899084935478,2742571,-1
198,1,STEP,899085025477,899088053045,3027568,-1
199,1,STEP,899088144444,899091386809,3242365,-1
200,1,STEP,899091478908,899094425577,2946669,-1
201,1,STEP,899094499876,899097480345,2980469,-1
202,1,STEP,899097551144,899100811009,3259865,-1
203,1,STEP,899100883908,899103763978,2880070,-1
204,1,STEP,899103836077,899107137542,3301465,-1
205,1,STEP,899107210341,899110249109,3038768,-1
206,1,STEP,899110365808,899114135068,3769260,-1
207,1,STEP,899114242867,899117354834,3111967,-1
208,1,STEP,899117463033,899120528300,3065267,-1
209,1,STEP,899120645899,899123964764,3318865,-1
210,1,STEP,899124038563,899126676835,2638272,-1
211,1,STEP,899126750734,899129995400,3244666,-1
212,1,STEP,899130069699,899133726760,3657061,-1
213,1,STEP,899133848259,899137795117,3946858,-1
214,1,STEP,899137925716,899142480767,4555051,-1
215,1,STEP,899142564166,899145392236,2828070,-1
216,1,STEP,899145496935,899149711091,4214156,-1
217,1,STEP,899149843589,899153610449,3766860,-1
218,1,STEP,899153701848,899157073912,3372064,-1
219,1,STEP,899157171011,899160047781,2876770,-1
220,1,STEP,899160142780,899163573243,3430463,-1
221,1,STEP,899163670342,899166653111,2982769,-1
222,1,STEP,899166750710,899170407071,3656361,-1
223,1,STEP,899170501170,899174890323,4389153,-1
224,1,STEP,899175028122,899179632273,4604151,-1
225,1,STEP,899179755072,899184322723,4567651,-1
226,1,STEP,899184472822,899188035984,3563162,-1
227,1,STEP,899188117683,899191309049,3191366,-1
228,1,STEP,899191390548,899194235118,2844570,-1
229,1,STEP,899194309617,899197376485,3066868,-1
230,1,STEP,899197450984,899201160045,3709061,-1
231,1,STEP,899201232044,899204251412,3019368,-1
232,1,STEP,899204323411,899206810085,2486674,-1
233,1,STEP,899206881084,899209921552,3040468,-1
234,1,STEP,899209997251,899212671523,2674272,-1
235,1,STEP,899212742822,899216528982,3786160,-1
236,1,STEP,899216604981,899219475751,2870770,-1
237,1,STEP,899219548450,899222970713,3422263,-1
238,1,STEP,899223043713,899225652885,2609172,-1
239,1,STEP,899225722584,899228918250,3195666,-1
240,1,STEP,899228993350,899232298615,3305265,-1
241,1,STEP,899232372814,899235477081,3104267,-1
242,1,STEP,899235549880,899238462649,2912769,-1
243,1,STEP,899238533148,899241589416,3056268,-1
244,1,STEP,899241659215,899244908481,3249266,-1
245,1,STEP,899244980280,899248644941,3664661,-1
246,1,STEP,899248721240,899251248214,2526974,-1
247,1,STEP,899251323313,899254021284,2697971,-1
248,1,STEP,899254095583,899257004053,2908470,-1
249,1,STEP,899257076452,899260118519,3042067,-1
250,1,STEP,899260193019,899263847980,3654961,-1
251,1,STEP,899263923679,899267009646,3085967,-1
252,1,STEP,899267083846,899270276312,3192466,-1
253,1,STEP,899270349511,899273093882,2744371,-1
254,1,STEP,899273165881,899276248848,3082967,-1
255,1,STEP,899276321048,899279385715,3064667,-1
256,1,STEP,899279497714,899282654080,3156366,-1
257,1,STEP,899282728080,899286352441,3624361,-1
258,1,STEP,899286440140,899289101712,2661572,-1
259,1,STEP,899289174611,899292382777,3208166,-1
260,1,STEP,899292456976,899296034439,3577463,-1
261,1,STEP,899296109038,899299029807,2920769,-1
262,1,STEP,899299104006,899302002675,2898669,-1
263,1,STEP,899302090574,899305910434,3819860,-1
264,1,STEP,899305986233,899309000001,3013768,-1
265,1,STEP,899309072400,899311556074,2483674,-1
266,1,STEP,899311670373,899314919738,3249365,-1
267,1,STEP,899315006437,899318438601,3432164,-1
268,1,STEP,899318529000,899320996774,2467774,-1
269,1,STEP,899321077673,899324158840,3081167,-1
270,1,STEP,899324248639,899327618804,3370165,-1
271,1,STEP,899327710403,899331034967,3324564,-1
272,1,STEP,899331121266,899334533230,3411964,-1
273,1,STEP,899334626429,899337140603,2514174,-1
274,1,STEP,899337226702,899339813874,2587172,-1
275,1,STEP,899339895373,899343204338,3308965,-1
276,1,STEP,899343292437,899346570403,3277966,-1
277,1,STEP,899346664802,899349480572,2815770,-1
278,1,STEP,899349560571,899352543339,2982768,-1
279,1,STEP,899352629338,899355621107,2991769,-1
280,1,STEP,899355706306,899358822873,3116567,-1
281,1,STEP,899358909872,899361454045,2544173,-1
282,1,STEP,899361536944,899364343914,2806970,-1
283,1,STEP,899364428113,899367258583,2830470,-1
284,1,STEP,899367342082,899370430849,3088767,-1
285,1,STEP,899370518849,899373621816,3102967,-1
286,1,STEP,899373702015,899376875181,3173166,-1
287,1,STEP,899376957080,899379818250,2861170,-1
288,1,STEP,899379899549,899382905917,3006368,-1
289,1,STEP,899382989716,899385376891,2387175,-1
290,1,STEP,899385456490,899388231961,2775471,-1
291,1,STEP,899388313460,899391016731,2703271,-1
292,1,STEP,899391108230,899394295496,3187266,-1
293,1,STEP,899394379895,899397359764,2979869,-1
294,1,STEP,899397448163,899400494131,3045968,-1
295,1,STEP,899400577830,899403937994,3360164,-1
296,1,STEP,899404023593,899406703165,2679572,-1
297,1,STEP,899406787064,899409816932,3029868,-1
298,1,STEP,899409914231,899412996698,3082467,-1
299,1,STEP,899413079197,899415886067,2806870,-1
300,1,STEP,899415973866,899418993134,3019268,-1
301,1,STEP,899419081333,899421492808,2411475,-1
302,1,STEP,899421574507,899424413877,2839370,-1
303,1,STEP,899424498376,899427393245,2894869,-1
304,1,STEP,899427475644,899430480513,3004869,-1
305,1,STEP,899430563012,899433650779,3087767,-1
306,1,STEP,899433732578,899436963544,3230966,-1
307,1,STEP,899437047143,899439726614,2679471,-1
308,1,STEP,899439811214,899442707483,2896269,-1
309,1,STEP,899442792682,899445181157,2388475,-1
310,1,STEP,899445265356,899448588020,3322664,-1
311,1,STEP,899448671120,899451795386,3124266,-1
312,1,STEP,899451873286,899454939953,3066667,-1
313,1,STEP,899455025052,899458016220,2991168,-1
314,1,STEP,899458101520,899460912590,2811070,-1
315,1,STEP,899460995489,899464052556,3057067,-1
316,1,STEP,899464135256,899466967326,2832070,-1
317,1,STEP,899467050525,899469763596,2713071,-1
318,1,STEP,899469844195,899472927062,3082867,-1
319,1,STEP,899473013161,899476223527,3210366,-1
320,1,STEP,899476307226,899479313595,3006369,-1
321,1,STEP,899479399194,899482722458,3323264,-1
322,1,STEP,899482814057,899485802526,2988469,-1
323,1,STEP,899485893325,899489206790,3313465,-1
324,1,STEP,899489295089,899491989860,2694771,-1
325,1,STEP,899492069959,899495277625,3207666,-1
326,1,STEP,899495359724,899498720089,3360365,-1
327,1,STEP,899498805288,899501656958,2851670,-1
328,1,STEP,899501737757,899504403728,2665971,-1
329,1,STEP,899504490028,899507623094,3133066,-1
330,1,STEP,899507699893,899510758561,3058668,-1
331,1,STEP,899510830660,899513803029,2972369,-1
332,1,STEP,899513895028,899516290602,2395574,-1
333,1,STEP,899516361602,899519476869,3115267,-1
334,1,STEP,899519548668,899522521036,2972368,-1
335,1,STEP,899522594936,899525232208,2637272,-1
336,1,STEP,899525303007,899528264375,2961368,-1
337,1,STEP,899528336275,899531187844,2851569,-1
338,1,STEP,899531259844,899534283912,3024068,-1
339,1,STEP,899534357211,899537119681,2762470,-1
340,1,STEP,899537189681,899540486646,3296965,-1
341,1,STEP,899540558945,899543702312,3143367,-1
342,1,STEP,899543783611,899546954277,3170666,-1
343,1,STEP,899547026176,899550241142,3214966,-1
344,1,STEP,899550313941,899553418109,3104168,-1
345,1,STEP,899553489608,899556267878,2778270,-1
346,1,STEP,899556337478,899559237947,2900469,-1
347,1,STEP,899559309646,899562287115,2977469,-1
348,1,STEP,899562359414,899565659679,3300265,-1
349,1,STEP,899565731878,899568933744,3201866,-1
350,1,STEP,899569005643,899571993912,2988269,-1
351,1,STEP,899572065611,899575019379,2953768,-1
352,1,STEP,899575090379,899578282545,3192166,-1
353,1,STEP,899578354344,899581192714,2838370,-1
354,1,STEP,899581263713,899584164182,2900469,-1
355,1,STEP,899584236382,899587727445,3491063,-1
356,1,STEP,899587801344,899590786412,2985068,-1
357,1,STEP,899590859711,899593786280,2926569,-1
358,1,STEP,899593857880,899596642650,2784770,-1
359,1,STEP,899596714049,899599715118,3001069,-1
360,1,STEP,899599786417,899603242980,3456563,-1
361,1,STEP,899603316879,899606207849,2890970,-1
362,1,STEP,899606281548,899608837221,2555673,-1
363,1,STEP,899608906520,899611367894,2461374,-1
364,1,STEP,899611438993,899614328963,2889970,-1
365,1,STEP,899614402062,899617453029,3050967,-1
366,1,STEP,899617523529,899620871093,3347564,-1
367,1,STEP,899620946492,899624164658,3218166,-1
368,1,STEP,899624238157,899627211426,2973269,-1
369,1,STEP,899627289525,899630192394,2902869,-1
370,1,STEP,899630265993,899632629968,2363975,-1
371,1,STEP,899632700368,899635816235,3115867,-1
372,1,STEP,899635890434,899639046000,3155566,-1
373,1,STEP,899639118700,899641964269,2845569,-1
374,1,STEP,899642056468,899644927338,2870870,-1
375,1,STEP,899645007537,899647806807,2799270,-1
376,1,STEP,899647897706,899650556378,2658672,-1
377,1,STEP,899650640677,899653497747,2857070,-1
378,1,STEP,899653577946,899656739613,3161667,-1
379,1,STEP,899656833012,899659832780,2999768,-1
380,1,STEP,899659920179,899663019046,3098867,-1
381,1,STEP,899663107645,899665645618,2537973,-1
382,1,STEP,899665730617,899668975083,3244466,-1
383,1,STEP,899669059482,899671963051,2903569,-1
384,1,STEP,899672046250,899675150817,3104567,-1
385,1,STEP,899675239916,899678177285,2937369,-1
386,1,STEP,899678267184,899681433251,3166067,-1
387,1,STEP,899681519150,899684535418,3016268,-1
388,1,STEP,899684619417,899687719984,3100567,-1
389,1,STEP,899687805583,899690495555,2689972,-1
390,1,STEP,899690587254,899693632821,3045567,-1
391,1,STEP,899693721220,899696695389,2974169,-1
392,1,STEP,899696783988,899699945154,3161166,-1
393,1,STEP,899700031554,899703087321,3055767,-1
394,1,STEP,899703172220,899706191388,3019168,-1
395,1,STEP,899706279987,899709745350,3465363,-1
396,1,STEP,899709834150,899712968816,3134666,-1
397,1,STEP,899713054515,899715809986,2755471,-1
398,1,STEP,899715891885,899718931653,3039768,-1
399,1,STEP,899719019052,899722513615,3494563,-1
400,1,STEP,899722599514,899725560083,2960569,-1
401,1,STEP,899725645182,899728387653,2742471,-1
402,1,STEP,899728470652,899730832027,2361375,-1
403,1,STEP,899730913926,899733969294,3055368,-1
404,1,STEP,899734054893,899736619865,2564972,-1
405,1,STEP,899736701865,899739565834,2863969,-1
406,1,STEP,899739649833,899742411804,2761971,-1
407,1,STEP,899742497203,899745655970,3158767,-1
408,1,STEP,899745740369,899749348730,3608361,-1
409,1,STEP,899749482829,899753136990,3654161,-1
410,1,STEP,899753226789,899756163858,2937069,-1
411,1,STEP,899756258757,899759539122,3280365,-1
412,1,STEP,899759633521,899762402592,2769071,-1
413,1,STEP,899762495191,899766008554,3513363,-1
414,1,STEP,899766101153,899769039922,2938769,-1
415,1,STEP,899769127521,899771597594,2470073,-1
416,1,STEP,899771696293,899774863360,3167067,-1
417,1,STEP,899774964559,899777666430,2701871,-1
418,1,STEP,899777754629,899780881096,3126467,-1
419,1,STEP,899780980595,899784022063,3041468,-1
420,1,STEP,899784113362,899787091730,2978368,-1
421,1,STEP,899787190029,899790049099,2859070,-1
422,1,STEP,899790136098,899793428063,3291965,-1
423,1,STEP,899793512062,899796611629,3099567,-1
424,1,STEP,899796695528,899799420999,2725471,-1
425,1,STEP,899799502598,899802464367,2961769,-1
426,1,STEP,899802551166,899805784832,3233666,-1
427,1,STEP,899805885231,899808521003,2635772,-1
428,1,STEP,899808623102,899812405462,3782360,-1
429,1,STEP,899812499161,899815704327,3205166,-1
430,1,STEP,899815800126,899818819094,3018968,-1
431,1,STEP,899818963492,899822300557,3337065,-1
432,1,STEP,899822417355,899825182026,2764671,-1
433,1,STEP,899825296525,899828899387,3602862,-1
434,1,STEP,899829019485,899831783156,2763671,-1
435,1,STEP,899831898755,899835192420,3293665,-1
436,1,STEP,899835307419,899838180388,2872969,-1
437,1,STEP,899838297087,899841385554,3088467,-1
438,1,STEP,899841498953,899845217814,3718861,-1
439,1,STEP,899845330512,899848630677,3300165,-1
440,1,STEP,899848754976,899851754644,2999668,-1
441,1,STEP,899851876843,899854527115,2650272,-1
442,1,STEP,899854643514,899857936879,3293365,-1
443,1,STEP,899858053677,899861813238,3759561,-1
444,1,STEP,899861940236,899865254401,3314165,-1
445,1,STEP,899865374400,899867939473,2565073,-1
446,1,STEP,899868036272,899871539534,3503262,-1
447,1,STEP,899871630133,899874825500,3195367,-1
448,1,STEP,899874917099,899877722969,2805870,-1
449,1,STEP,899877813268,899880724337,2911069,-1
450,1,STEP,899880814636,899883646706,2832070,-1
451,1,STEP,899883736905,899886816972,3080067,-1
452,1,STEP,899886914871,899890032238,3117367,-1
453,1,STEP,899890128837,899893143305,3014468,-1
454,1,STEP,899893231704,899896303072,3071368,-1
455,1,STEP,899896392171,899899542637,3150466,-1
456,1,STEP,899899629336,899902717604,3088268,-1
457,1,STEP,899902805203,899905765071,2959868,-1
458,1,STEP,899905851070,899909322635,3471565,-1
459,1,STEP,899909413434,899912725600,3312166,-1
460,1,STEP,899912814899,899915894968,3080069,-1
461,1,STEP,899915989667,899919101135,3111468,-1
462,1,STEP,899919196635,899922194304,2997669,-1
463,1,STEP,899922283003,899925488071,3205068,-1
464,1,STEP,899925574570,899928863937,3289367,-1
465,1,STEP,899928953236,899932494300,3541064,-1
466,1,STEP,899932578199,899935915265,3337066,-1
467,1,STEP,899936004964,899939291831,3286867,-1
468,1,STEP,899939384030,899942792095,3408065,-1
469,1,STEP,899942891294,899946292660,3401366,-1
470,1,STEP,899946389459,899949973623,3584164,-1
471,1,STEP,899950065322,899952986392,2921070,-1
472,1,STEP,899953072491,899956735354,3662863,-1
473,1,STEP,899956831853,899960164520,3332667,-1
474,1,STEP,899960253219,899963925181,3671962,-1
475,1,STEP,899964014681,899966858252,2843571,-1
476,1,STEP,899966970751,899970001120,3030369,-1
477,1,STEP,899970086019,899973347286,3261267,-1
478,1,STEP,899973435185,899976973949,3538764,-1
479,1,STEP,899977061848,899980093718,3031870,-1
480,1,STEP,899980176617,899983150287,2973670,-1
481,1,STEP,899983238386,899986291355,3052969,-1
482,1,STEP,899986378254,899988840929,2462675,-1
483,1,STEP,899988924828,899991838899,2914071,-1
484,1,STEP,899991925698,899994818468,2892770,-1
485,1,STEP,899994912268,899998357133,3444865,-1
486,1,STEP,899998446032,900001206704,2760672,-1
487,1,STEP,900001300403,900004138174,2837771,-1
488,1,STEP,900004225573,900007666138,3440565,-1
489,1,STEP,900007757337,900010985005,3227668,-1
490,1,STEP,900011070304,900013972174,2901870,-1
491,1,STEP,900014064574,900016768346,2703772,-1
492,1,STEP,900016853945,900020256911,3402966,-1
493,1,STEP,900020347310,900022947984,2600674,-1
494,1,STEP,900023034283,900025787555,2753272,-1
495,1,STEP,900025882354,900028559827,2677473,-1
496,1,STEP,900028645726,900031532097,2886371,-1
497,1,STEP,900031617796,900034589766,2971970,-1
498,1,STEP,900034673065,900038502426,3829361,-1
499,1,STEP,900038601225,900041740993,3139768,-1
500,1,STEP,900041826792,900045185058,3358266,-1
501,1,STEP,900045269457,900048105529,2836072,-1
502,1,STEP,900048192328,900051549894,3357566,-1
503,1,STEP,900051635793,900054777761,3141968,-1
504,1,STEP,900054869760,900057890130,3020370,-1
505,1,STEP,900057983429,900060933499,2950070,-1
506,1,STEP,900061018998,900063838269,2819271,-1
507,1,STEP,900063923669,900066988437,3064768,-1
508,1,STEP,900067082936,900070137406,3054470,-1
509,1,STEP,900070222405,900073203075,2980670,-1
510,1,STEP,900073294674,900076215644,2920970,-1
511,1,STEP,900076305743,900079440711,3134968,-1
512,1,STEP,900079575510,900082560780,2985270,-1
513,1,STEP,900082644279,900085351751,2707472,-1
514,1,STEP,900085434751,900088458920,3024169,-1
515,1,STEP,900088543819,900091344991,2801172,-1
516,1,STEP,900091427690,900094680157,3252467,-1
517,1,STEP,900094761256,900097765626,3004370,-1
518,1,STEP,900097849825,900101227091,3377266,-1
519,1,STEP,900101319590,900104439958,3120368,-1
520,1,STEP,900104529257,900107925123,3395866,-1
521,1,STEP,900108010622,900111297989,3287367,-1
522,1,STEP,900111384788,900114650955,3266167,-1
523,1,STEP,900114742554,900118009521,3266967,-1
524,1,STEP,900118101020,900121348487,3247467,-1
525,1,STEP,900121433586,900125073949,3640363,-1
526,1,STEP,900125165548,900128396115,3230567,-1
527,1,STEP,900128485315,900131351185,2865870,-1
528,1,STEP,900131440185,900134256256,2816071,-1
529,1,STEP,900134344955,900137639122,3294167,-1
530,1,STEP,900137726021,900140913889,3187868,-1
531,1,STEP,900140996088,900144357154,3361066,-1
532,1,STEP,900144442253,900147214725,2772472,-1
533,1,STEP,900147305324,900150555491,3250167,-1
534,1,STEP,900150641490,900153422862,2781372,-1
535,1,STEP,900153512761,900156634429,3121668,-1
536,1,STEP,900156726428,900159594799,2868371,-1
537,1,STEP,900159677899,900162339072,2661173,-1
538,1,STEP,900162422571,900166253532,3830961,-1
539,1,STEP,900166338331,900168837706,2499375,-1
540,1,STEP,900168925805,900171902175,2976370,-1
541,1,STEP,900171987274,900175359140,3371866,-1
542,1,STEP,900175445539,900177705016,2259477,-1
543,1,STEP,900177793515,900180954983,3161468,-1
544,1,STEP,900181045782,900183963853,2918071,-1
545,1,STEP,900184045352,900187447517,3402165,-1
546,1,STEP,900187534116,900190266489,2732373,-1
547,1,STEP,900190351188,900193683354,3332166,-1
548,1,STEP,900193767753,900197397116,3629363,-1
549,1,STEP,900197488616,900200610184,3121568,-1
550,1,STEP,900200694183,900203917850,3223667,-1
551,1,STEP,900204003350,900207028019,3024669,-1
552,1,STEP,900207125018,900210033188,2908170,-1
553,1,STEP,900210117788,900213316955,3199167,-1
554,1,STEP,900213402854,900216835420,3432566,-1
555,1,STEP,900216920419,900220164886,3244467,-1
556,1,STEP,900220258485,900223141356,2882871,-1
557,1,STEP,900223234555,900226036326,2801771,-1
558,1,STEP,900226124425,900229511991,3387566,-1
559,1,STEP,900229602590,900232470961,2868371,-1
560,1,STEP,900232563460,900235249233,2685773,-1
561,1,STEP,900235339032,900237940106,2601074,-1
562,1,STEP,900238026705,900240692478,2665773,-1
563,1,STEP,900240776277,900244032444,3256167,-1
564,1,STEP,900244133743,900247654107,3520364,-1
565,1,STEP,900247740207,900250816775,3076568,-1
566,1,STEP,900250901175,900253853245,2952070,-1
567,1,STEP,900253954744,900257188611,3233867,-1
568,1,STEP,900257279710,900260140081,2860371,-1
569,1,STEP,900260225480,900263327349,3101869,-1
570,1,STEP,900263418748,900266801213,3382465,-1
571,1,STEP,900266894313,900270267878,3373565,-1
572,1,STEP,900270355677,900273276648,2920971,-1
573,1,STEP,900273358447,900276327817,2969370,-1
574,1,STEP,900276411516,900279524085,3112569,-1
575,1,STEP,900279607884,900282806551,3198667,-1
576,1,STEP,900282892050,900285765121,2873071,-1
577,1,STEP,900285851121,900288979689,3128568,-1
578,1,STEP,900289070188,900292184756,3114568,-1
579,1,STEP,900292274955,900295348424,3073469,-1
580,1,STEP,900295433323,900298291294,2857971,-1
581,1,STEP,900298374094,900301020467,2646373,-1
582,1,STEP,900301102166,900304429932,3327766,-1
583,1,STEP,900304515431,900307177804,2662373,-1
584,1,STEP,900307266204,900310221074,2954870,-1
585,1,STEP,900310311673,900313358042,3046369,-1
586,1,STEP,900313447641,900316757007,3309366,-1
587,1,STEP,900316845607,900320049574,3203967,-1
588,1,STEP,900320141473,900323581738,3440265,-1
589,1,STEP,900323670437,900326574208,2903771,-1
590,1,STEP,900326656607,900329851675,3195068,-1
591,1,STEP,900329950174,900333254540,3304366,-1
592,1,STEP,900333361439,900337402298,4040859,-1
593,1,STEP,900337502597,900340547866,3045269,-1
594,1,STEP,900340643965,900343322538,2678573,-1
595,1,STEP,900343418637,900346300608,2881971,-1
596,1,STEP,900346394407,900349069680,2675273,-1
597,1,STEP,900349164479,900352040250,2875771,-1
598,1,STEP,900352148949,900354936721,2787772,-1
599,1,STEP,900355029820,900358415585,3385765,-1
600,1,STEP,900358510984,900361712152,3201168,-1
601,1,STEP,900361807251,900365083418,3276167,-1
602,1,STEP,900365182417,900368186686,3004269,-1
603,1,STEP,900368280986,900371447153,3166167,-1
604,1,STEP,900371547452,900374565122,3017670,-1
605,1,STEP,900374658921,900378157685,3498764,-1
606,1,STEP,900378250985,900381158255,2907270,-1
607,1,STEP,900381251854,900384350023,3098169,-1
608,1,STEP,900384445322,900387470191,3024869,-1
609,1,STEP,900387571990,900390626959,3054969,-1
610,1,STEP,900390721658,900393814427,3092769,-1
611,1,STEP,900393915926,900396545299,2629373,-1
612,1,STEP,900396639498,900399502469,2862971,-1
613,1,STEP,900399594468,900402279341,2684873,-1
614,1,STEP,900402371540,900405683207,3311667,-1
615,1,STEP,900405774406,900408752276,2977870,-1
616,1,STEP,900408845775,900411653046,2807271,-1
617,1,STEP,900411744545,900414374919,2630374,-1
618,1,STEP,900414467618,900417958182,3490564,-1
619,1,STEP,900418054881,900421286249,3231368,-1
620,1,STEP,900421382048,900424490116,3108068,-1
621,1,STEP,900424582515,900427375287,2792772,-1
622,1,STEP,900427466086,900430308257,2842171,-1
623,1,STEP,900430401756,900433513925,3112169,-1
624,1,STEP,900433609324,900436939390,3330066,-1
625,1,STEP,900437035189,900440307856,3272667,-1
626,1,STEP,900440399655,900443461624,3061969,-1
627,1,STEP,900443556523,900446818090,3261567,-1
628,1,STEP,900446909289,900451387244,4477955,-1
629,1,STEP,900451479543,900454661711,3182168,-1
630,1,STEP,900454781909,900458670370,3888461,-1
631,1,STEP,900458748769,900461707439,2958670,-1
632,1,STEP,900461784538,900464884307,3099769,-1
633,1,STEP,900464959106,900468094074,3134968,-1
634,1,STEP,900468176274,900471326642,3150368,-1
635,1,STEP,900471408341,900474586609,3178268,-1
636,1,STEP,900474697008,900477275881,2578873,-1
637,1,STEP,900477384280,900480907245,3522965,-1
638,1,STEP,900481019444,900484330810,3311366,-1
639,1,STEP,900484445409,900487218781,2773372,-1
640,1,STEP,900487333980,900490337249,3003269,-1
641,1,STEP,900490447848,900493567416,3119568,-1
642,1,STEP,900493679715,900496705485,3025770,-1
643,1,STEP,900496815684,900499777754,2962070,-1
644,1,STEP,900499890752,900503463716,3572964,-1
645,1,STEP,900503574915,900506919681,3344766,-1
646,1,STEP,900507019880,900510121549,3101669,-1
647,1,STEP,900510224548,900513719212,3494664,-1
648,1,STEP,900513809911,900516933480,3123569,-1
649,1,STEP,900517023879,900520674142,3650263,-1
650,1,STEP,900520767141,900523783210,3016069,-1
651,1,STEP,900523876809,900526645381,2768572,-1
652,1,STEP,900526734780,900529954748,3219968,-1
653,1,STEP,900530050847,900532733620,2682773,-1
654,1,STEP,900532828419,900536034986,3206567,-1
655,1,STEP,900536131785,900539547251,3415466,-1
656,1,STEP,900539637950,900542785718,3147768,-1
657,1,STEP,900542873817,900545953386,3079569,-1
658,1,STEP,900546049785,900548762657,2712872,-1
659,1,STEP,900548853156,900552276922,3423766,-1
660,1,STEP,900552369321,900555835186,3465865,-1
661,1,STEP,900555929085,900559297551,3368466,-1
662,1,STEP,900559389850,900562494118,3104268,-1
663,1,STEP,900562586217,900565879684,3293467,-1
664,1,STEP,900565980583,900569163551,3182968,-1
665,1,STEP,900569253650,900572748814,3495164,-1
666,1,STEP,900572843113,900575911282,3068169,-1
667,1,STEP,900576013681,900579060950,3047269,-1
668,1,STEP,900579156049,900582096120,2940071,-1
669,1,STEP,900582197419,900584750093,2552674,-1
670,1,STEP,900584840192,900588645753,3805561,-1
671,1,STEP,900588738752,900592105318,3366566,-1
672,1,STEP,900592195517,900595484384,3288867,-1
673,1,STEP,900595584783,900598470754,2885971,-1
674,1,STEP,900598566653,900601487023,2920370,-1
675,1,STEP,900601576822,900604834689,3257867,-1
676,1,STEP,900604928388,900607859459,2931071,-1
677,1,STEP,900607953658,900611415723,3462065,-1
678,1,STEP,900611527222,900614170595,2643373,-1
679,1,STEP,900614280994,900617540761,3259767,-1
680,1,STEP,900617658959,900621226523,3567564,-1
681,1,STEP,900621346622,900624675288,3328666,-1
682,1,STEP,900624782687,900628346751,3564064,-1
683,1,STEP,900628481650,900631825516,3343866,-1
684,1,STEP,900631948515,900635069883,3121368,-1
685,1,STEP,900635189582,900638700146,3510564,-1
686,1,STEP,900638828445,900641841815,3013370,-1
687,1,STEP,900641951213,900645473678,3522465,-1
688,1,STEP,900645569577,900648572246,3002669,-1
689,1,STEP,900648670945,900652045111,3374166,-1
690,1,STEP,900652158510,900655209979,3051469,-1
691,1,STEP,900655329878,900658555645,3225767,-1
692,1,STEP,900658672644,900662670304,3997660,-1
693,1,STEP,900662794602,900665510475,2715873,-1
694,1,STEP,900665630274,900668578144,2947870,-1
695,1,STEP,900668697842,900671590013,2892171,-1
696,1,STEP,900671699912,900674401085,2701173,-1
697,1,STEP,900674507184,900677349355,2842171,-1
698,1,STEP,900677462454,900680654021,3191567,-1
699,1,STEP,900680777120,900684083987,3306867,-1
700,1,STEP,900684200485,900687461052,3260567,-1
701,1,STEP,900687582751,900690749319,3166568,-1
702,1,STEP,900690842718,900694333983,3491265,-1
703,1,STEP,900694437982,900697268953,2830971,-1
704,1,STEP,900697383852,900700560920,3177068,-1
705,1,STEP,900700679719,900703387791,2708072,-1
706,1,STEP,900703504390,900706162063,2657673,-1
707,1,STEP,900706284262,900709331831,3047569,-1
708,1,STEP,900709450430,900712627098,3176668,-1
709,1,STEP,900712752896,900715964864,3211968,-1
710,1,STEP,900716087962,900719430929,3342967,-1
711,1,STEP,900719554827,900722348899,2794072,-1
712,1,STEP,900722470798,900725576866,3106068,-1
713,1,STEP,900725701265,900729542526,3841261,-1
714,1,STEP,900729666325,900732716494,3050169,-1
715,1,STEP,900732839793,900736115060,3275267,-1
716,1,STEP,900736241758,900739402526,3160768,-1
717,1,STEP,900739525925,900742390796,2864871,-1
718,1,STEP,900742511395,900745285767,2774372,-1
719,1,STEP,900745406065,900748581533,3175468,-1
720,1,STEP,900748701932,900752122097,3420165,-1
721,1,STEP,900752242996,900755231166,2988170,-1
722,1,STEP,900755353165,900758960628,3607463,-1
723,1,STEP,900759078027,900762150496,3072469,-1
724,1,STEP,900762259495,900765764959,3505464,-1
725,1,STEP,900765891058,900769257124,3366066,-1
726,1,STEP,900769374123,900772495491,3121368,-1
727,1,STEP,900772610290,900775835457,3225167,-1
728,1,STEP,900775945656,900779027725,3082069,-1
729,1,STEP,900779156024,900782671988,3515964,-1
730,1,STEP,900782791887,900786559249,3767362,-1
731,1,STEP,900786678847,900789880815,3201968,-1
732,1,STEP,900789995414,900792790585,2795171,-1
733,1,STEP,900792903484,900795855454,2951970,-1
734,1,STEP,900795968553,900798608327,2639774,-1
735,1,STEP,900798729325,900801581796,2852471,-1
736,1,STEP,900801692695,900804793264,3100569,-1
737,1,STEP,900804897163,900807698334,2801171,-1
738,1,STEP,900807802333,900810748204,2945871,-1
739,1,STEP,900810872702,900814068170,3195468,-1
740,1,STEP,900814178869,900817012240,2833371,-1
741,1,STEP,900817126139,900819973710,2847571,-1
742,1,STEP,900820085809,900823323076,3237267,-1
743,1,STEP,900823440775,900827164637,3723862,-1
744,1,STEP,900827282636,900830476804,3194168,-1
745,1,STEP,900830585003,900834560162,3975159,-1
746,1,STEP,900834669761,900837914028,3244267,-1
747,1,STEP,900838024727,900840734600,2709873,-1
748,1,STEP,900840831099,900844153065,3321966,-1
749,1,STEP,900844277964,900846830038,2552074,-1
750,1,STEP,900846936937,900850203604,3266667,-1
751,1,STEP,900850317103,900853617769,3300666,-1
752,1,STEP,900853727868,900856795637,3067769,-1
753,1,STEP,900856904536,900859545309,2640773,-1
754,1,STEP,900859657108,900863056874,3399766,-1
755,1,STEP,900863171073,900865977144,2806071,-1
756,1,STEP,900866085543,900869187212,3101669,-1
757,1,STEP,900869285311,900872513778,3228467,-1
758,1,STEP,900872626177,900876222540,3596363,-1
759,1,STEP,900876331139,900879696905,3365766,-1
760,1,STEP,900879806704,900882616876,2810172,-1
761,1,STEP,900882714075,900886113640,3399565,-1
762,1,STEP,900886210039,900889169509,2959470,-1
763,1,STEP,900889262208,900892125979,2863771,-1
764,1,STEP,900892219278,900895003850,2784572,-1
765,1,STEP,900895095349,900897906421,2811072,-1
766,1,STEP,900897998020,900901108088,3110068,-1
767,1,STEP,900901206287,900904635553,3429266,-1
768,1,STEP,900904745651,900907678022,2932371,-1
769,1,STEP,900907773321,900910197596,2424275,-1
770,1,STEP,900910287495,900913629061,3341566,-1
771,1,STEP,900913721961,900916797429,3075468,-1
772,1,STEP,900916889628,900919834299,2944671,-1
773,1,STEP,900919927998,900923519261,3591263,-1
774,1,STEP,900923620860,900926544931,2924071,-1
775,1,STEP,900926638130,900929708599,3070469,-1
776,1,STEP,900929801898,900933181863,3379965,-1
777,1,STEP,900933276862,900936196433,2919571,-1
778,1,STEP,900936289332,900939379301,3089969,-1
779,1,STEP,900939475500,900942729567,3254067,-1
780,1,STEP,900942826466,900945476639,2650173,-1
781,1,STEP,900945572238,900948002313,2430075,-1
782,1,STEP,900948098112,900951283480,3185368,-1
783,1,STEP,900951379779,900954336149,2956370,-1
784,1,STEP,900954430548,900957240620,2810072,-1
785,1,STEP,900957336419,900960494187,3157768,-1
786,1,STEP,900960588086,900963714954,3126868,-1
787,1,STEP,900963809053,900966472126,2663073,-1
788,1,STEP,900966567325,900969907691,3340366,-1
789,1,STEP,900970009890,900973197358,3187468,-1
790,1,STEP,900973299757,900976785822,3486065,-1
791,1,STEP,900976883821,900980066188,3182367,-1
792,1,STEP,900980163088,900983463254,3300166,-1
793,1,STEP,900983560253,900986789920,3229667,-1
794,1,STEP,900986889419,900990367184,3477765,-1
795,1,STEP,900990469183,900993653251,3184068,-1
796,1,STEP,900993750950,900997198115,3447165,-1
797,1,STEP,900997299714,901000019386,2719672,-1
798,1,STEP,901000119885,901003437352,3317467,-1
799,1,STEP,901003533651,901006527220,2993569,-1
800,1,STEP,901006624919,901009529490,2904571,-1
801,1,STEP,901009625089,901013074854,3449765,-1
802,1,STEP,901013172553,901015765427,2592874,-1
803,1,STEP,901015861826,901019593188,3731362,-1
804,1,STEP,901019691087,901023338450,3647363,-1
805,1,STEP,901023436049,901026196121,2760072,-1
806,1,STEP,901026292520,901029551787,3259267,-1
807,1,STEP,901029647886,901032809554,3161668,-1
808,1,STEP,901032904953,901035720025,2815072,-1
809,1,STEP,901035814324,901038773694,2959370,-1
810,1,STEP,901038868893,901041525866,2656973,-1
811,1,STEP,901041621965,901044811633,3189668,-1
812,1,STEP,901044908332,901048260598,3352266,-1
813,1,STEP,901048359297,901051425066,3065769,-1
814,1,STEP,901051524065,901054489435,2965370,-1
815,1,STEP,901054586034,901058407995,3821961,-1
816,1,STEP,901058505294,901062277456,3772162,-1
817,1,STEP,901062373355,901065716521,3343166,-1
818,1,STEP,901065813820,901068998588,3184768,-1
819,1,STEP,901069093687,901072226555,3132868,-1
820,1,STEP,901072323954,901075172825,2848871,-1
821,1,STEP,901075276124,901078407492,3131368,-1
822,1,STEP,901078508991,901081359662,2850671,-1
823,1,STEP,901081457561,901084701629,3244068,-1
824,1,STEP,901084797028,901087345502,2548474,-1
825,1,STEP,901087445101,901090266972,2821871,-1
826,1,STEP,901090362171,901093631538,3269367,-1
827,1,STEP,901093727837,901096272511,2544674,-1
828,1,STEP,901096390510,901099293281,2902771,-1
829,1,STEP,901099389280,901102376050,2986770,-1
830,1,STEP,901102472949,901105230021,2757072,-1
831,1,STEP,901105323220,901108178191,2854971,-1
832,1,STEP,901108270490,901111417658,3147168,-1
833,1,STEP,901111512757,901114241329,2728572,-1
834,1,STEP,901114341828,901117469297,3127469,-1
835,1,STEP,901117562596,901120523166,2960570,-1
836,1,STEP,901120622565,901124185829,3563264,-1
837,1,STEP,901124281428,901127338897,3057469,-1
838,1,STEP,901127433396,901130264167,2830771,-1
839,1,STEP,901130372066,901133093538,2721472,-1
840,1,STEP,901133188837,901136182407,2993570,-1
841,1,STEP,901136278206,901139282676,3004470,-1
842,1,STEP,901139379075,901142260346,2881271,-1
843,1,STEP,901142357145,901145690011,3332866,-1
844,1,STEP,901145779710,901149085076,3305366,-1
845,1,STEP,901149179875,901152491242,3311367,-1
846,1,STEP,901152586841,901155992306,3405465,-1
847,1,STEP,901156086406,901159446671,3360265,-1
848,1,STEP,901159539771,901162842337,3302566,-1
849,1,STEP,901162936436,901166551400,3614964,-1
850,1,STEP,901166646299,901169399871,2753572,-1
851,1,STEP,901169492370,901172755537,3263167,-1
852,1,STEP,901172849436,901176453799,3604363,-1
853,1,STEP,901176548598,901179783765,3235167,-1
854,1,STEP,901179902864,901182699136,2796272,-1
855,1,STEP,901182793635,901185679106,2885471,-1
856,1,STEP,901185774305,901188647776,2873471,-1
857,1,STEP,901188739875,901191844643,3104768,-1
858,1,STEP,901191941342,901195395507,3454165,-1
859,1,STEP,901195492206,901198808173,3315967,-1
860,1,STEP,901198908072,901202135939,3227867,-1
861,1,STEP,901202232738,901205392906,3160168,-1
862,1,STEP,901205483205,901208888171,3404966,-1
863,1,STEP,901208982970,901212402435,3419465,-1
864,1,STEP,901212496134,901216405895,3909761,-1
865,1,STEP,901216504494,901219713661,3209167,-1
866,1,STEP,901219814260,901222817330,3003070,-1
867,1,STEP,901222936128,901226562592,3626464,-1
868,1,STEP,901226691790,901230510152,3818362,-1
869,1,STEP,901230646150,901234622110,3975960,-1
870,1,STEP,901234752009,901238410872,3658863,-1
871,1,STEP,901238543170,901241511440,2968270,-1
872,1,STEP,901241621739,901244903806,3282067,-1
873,1,STEP,901245022205,901249239762,4217557,-1
874,1,STEP,901249362761,901252327831,2965070,-1
875,1,STEP,901252443229,901255698096,3254867,-1
876,1,STEP,901255815895,901259147062,3331167,-1
877,1,STEP,901259233961,901262234530,3000569,-1
878,1,STEP,901262322129,901265830094,3507965,-1
879,1,STEP,901265937293,901268978262,3040969,-1
880,1,STEP,901269064961,901272631425,3566464,-1
881,1,STEP,901272723124,901275578195,2855071,-1
882,1,STEP,901275663994,901278359267,2695273,-1
883,1,STEP,901278442766,901281346237,2903471,-1
884,1,STEP,901281435036,901284167708,2732672,-1
885,1,STEP,901284256707,901287744972,3488265,-1
886,1,STEP,901287831171,901290870740,3039569,-1
887,1,STEP,901290956239,901294167307,3211068,-1
888,1,STEP,901294252306,901297055778,2803472,-1
889,1,STEP,901297140877,901300575642,3434765,-1
890,1,STEP,901300665641,901303779209,3113568,-1
891,1,STEP,901303871809,901307353273,3481464,-1
892,1,STEP,901307443672,901310558341,3114669,-1
893,1,STEP,901310645940,901313112715,2466775,-1
894,1,STEP,901313195614,901316266083,3070469,-1
895,1,STEP,901316354882,901319137654,2782772,-1
896,1,STEP,901319224153,901322499220,3275067,-1
897,1,STEP,901322586919,901325842986,3256067,-1
898,1,STEP,901325946785,901328728557,2781772,-1
899,1,STEP,901328813156,901332454219,3641063,-1
900,1,STEP,901332547518,901335284090,2736572,-1
901,1,STEP,901335368389,901338598457,3230068,-1
902,1,STEP,901338687556,901341654926,2967370,-1
903,1,STEP,901341739925,901345959482,4219557,-1
904,1,STEP,901346043981,901349270249,3226268,-1
905,1,STEP,901349358448,901352185419,2826971,-1
906,1,STEP,901352266718,901355238788,2972070,-1
907,1,STEP,901355320987,901358561855,3240868,-1
908,1,STEP,901358646654,901361426926,2780272,-1
909,1,STEP,901361514225,901364182098,2667873,-1
910,1,STEP,901364266397,901366977669,2711272,-1
911,1,STEP,901367061668,901370525833,3464165,-1
912,1,STEP,901370616632,901373089107,2472475,-1
913,1,STEP,901373172607,901376266575,3093968,-1
914,1,STEP,901376352974,901379477943,3124969,-1
915,1,STEP,901379567842,901382698310,3130468,-1
916,1,STEP,901382789409,901385391083,2601674,-1
917,1,STEP,901385476882,901387980057,2503175,-1
918,1,STEP,901388062856,901391040126,2977270,-1
919,1,STEP,901391127925,901394383592,3255667,-1
920,1,STEP,901394470391,901397736858,3266467,-1
921,1,STEP,901397821357,901401213623,3392266,-1
922,1,STEP,901401301422,901404030394,2728972,-1
923,1,STEP,901404114193,901407413560,3299367,-1
924,1,STEP,901407502959,901410103732,2600773,-1
925,1,STEP,901410195432,901413492498,3297066,-1
926,1,STEP,901413576897,901416673566,3096669,-1
927,1,STEP,901416758865,901419349239,2590374,-1
928,1,STEP,901419433238,901422120711,2687473,-1
929,1,STEP,901422208910,901425269679,3060769,-1
930,1,STEP,901425355078,901428156250,2801172,-1
931,1,STEP,901428245249,901430882422,2637173,-1
932,1,STEP,901430966821,901434380787,3413966,-1
933,1,STEP,901434471386,901437584954,3113568,-1
934,1,STEP,901437667853,901440861321,3193468,-1
935,1,STEP,901440945320,901444513184,3567864,-1
936,1,STEP,901444604183,901448027048,3422865,-1
937,1,STEP,901448112747,901450932519,2819772,-1
938,1,STEP,901451014518,901454425883,3411365,-1
939,1,STEP,901454557882,901457250555,2692673,-1
940,1,STEP,901457332754,901460411023,3078269,-1
941,1,STEP,901460496722,901463358193,2861471,-1
942,1,STEP,901463441492,901466201964,2760472,-1
943,1,STEP,901466285063,901469096135,2811072,-1
944,1,STEP,901469178634,901472184704,3006070,-1
945,1,STEP,901472268403,901475486870,3218467,-1
946,1,STEP,901475569869,901478993635,3423766,-1
947,1,STEP,901479080034,901482083403,3003369,-1
948,1,STEP,901482165503,901484429980,2264477,-1
949,1,STEP,901484507279,901488098342,3591063,-1
950,1,STEP,901488183642,901491482608,3298966,-1
951,1,STEP,901491569807,901494505978,2936171,-1
952,1,STEP,901494589277,901497930343,3341066,-1
953,1,STEP,901498012842,901500324819,2311977,-1
954,1,STEP,901500402918,901503701184,3298266,-1
955,1,STEP,901503785684,901506680654,2894970,-1
956,1,STEP,901506764753,901510350017,3585264,-1
957,1,STEP,901510432916,901513494785,3061869,-1
958,1,STEP,901513575384,901516515755,2940371,-1
959,1,STEP,901516595754,901519434525,2838771,-1
960,1,STEP,901519520224,901522618593,3098369,-1
961,1,STEP,901522700692,901526098157,3397465,-1
962,1,STEP,901526181957,901529406324,3224367,-1
963,1,STEP,901529490023,901532354994,2864971,-1
964,1,STEP,901532434593,901535503462,3068869,-1
965,1,STEP,901535586961,901539108726,3521765,-1
966,1,STEP,901539204525,901542272794,3068269,-1
967,1,STEP,901542357093,901545178464,2821371,-1
968,1,STEP,901545261563,901548282433,3020870,-1
969,1,STEP,901548375232,901550924406,2549174,-1
970,1,STEP,901551007605,901553679278,2671673,-1
971,1,STEP,901553764577,901556680748,2916171,-1
972,1,STEP,901556773347,901559775916,3002569,-1
973,1,STEP,901559858216,901562745486,2887270,-1
974,1,STEP,901562830585,901565795055,2964470,-1
975,1,STEP,901565903254,901568932324,3029070,-1
976,1,STEP,901569020023,901572182691,3162668,-1
977,1,STEP,901572273790,901574953363,2679573,-1
978,1,STEP,901575035862,901578219330,3183468,-1
979,1,STEP,901578311929,901581508496,3196567,-1
980,1,STEP,901581601695,901584702864,3101169,-1
981,1,STEP,901584788163,901587524535,2736372,-1
982,1,STEP,901587617734,901590635704,3017970,-1
983,1,STEP,901590722703,901593838171,3115468,-1
984,1,STEP,901593929870,901596790641,2860771,-1
985,1,STEP,901596878441,901599717212,2838771,-1
986,1,STEP,901599803011,901602416484,2613473,-1
987,1,STEP,901602502584,901605707251,3204667,-1
988,1,STEP,901605795250,901608836919,3041669,-1
989,1,STEP,901608925419,901611855289,2929870,-1
990,1,STEP,901611943088,901614440063,2496975,-1
991,1,STEP,901614524062,901617471832,2947770,-1
992,1,STEP,901617556131,901620456002,2899871,-1
993,1,STEP,901620540701,901623470671,2929970,-1
994,1,STEP,901623553770,901626249743,2695973,-1
995,1,STEP,901626333742,901629803007,3469265,-1
996,1,STEP,901629895906,901632776177,2880271,-1
997,1,STEP,901632863776,901635931945,3068169,-1
998,1,STEP,901636015344,901639022314,3006970,-1
999,1,STEP,901639108013,901642168382,3060369,-1
