Gen,Resource,Stamp,TimeStamp_Start,TimeStamp_End,Duration,Indiv_id
0,1,FirstEvaluation,966799266546,967596657155,797390609,-1
0,1,STEP,967596862053,967602641703,5779650,-1
1,1,STEP,967602737402,967607178063,4440661,-1
2,1,STEP,967607272062,967612076220,4804158,-1
3,1,STEP,967612169319,967616300883,4131564,-1
4,1,STEP,967616391082,967619794252,3403170,-1
5,1,STEP,967619882152,967624420912,4538760,-1
6,1,STEP,967624512911,967628819673,4306762,-1
7,1,STEP,967628908872,967633034736,4125864,-1
8,1,STEP,967633130735,967636596705,3465970,-1
9,1,STEP,967636685804,967641516862,4831058,-1
10,1,STEP,967641605561,967645127530,3521969,-1
11,1,STEP,967645218229,967650716781,5498552,-1
12,1,STEP,967650855280,967658642612,7787332,-1
13,1,STEP,967658768311,967664816458,6048147,-1
14,1,STEP,967664945457,967670216910,5271453,-1
15,1,STEP,967670313109,967673586581,3273472,-1
16,1,STEP,967673676880,967678037042,4360162,-1
17,1,STEP,967678126141,967682515902,4389761,-1
18,1,STEP,967682587102,967686406368,3819266,-1
19,1,STEP,967686501968,967689769439,3267471,-1
20,1,STEP,967689854638,967694178700,4324062,-1
21,1,STEP,967694275799,967699171956,4896157,-1
22,1,STEP,967699257656,967702406828,3149172,-1
23,1,STEP,967702513027,967706471992,3958965,-1
24,1,STEP,967706564092,967710850154,4286062,-1
25,1,STEP,967710943853,967714920418,3976565,-1
26,1,STEP,967715016318,967719412179,4395861,-1
27,1,STEP,967719537278,967723921539,4384261,-1
28,1,STEP,967723997339,967727538508,3541169,-1
29,1,STEP,967727607707,967732242067,4634360,-1
30,1,STEP,967732313166,967736027833,3714667,-1
31,1,STEP,967736098233,967739836800,3738567,-1
32,1,STEP,967739916499,967743689466,3772967,-1
33,1,STEP,967743758066,967747056337,3298271,-1
34,1,STEP,967747124136,967751244900,4120764,-1
35,1,STEP,967751357799,967754936568,3578769,-1
36,1,STEP,967755042167,967758604335,3562168,-1
37,1,STEP,967758712234,967761905306,3193072,-1
38,1,STEP,967762024505,967765014779,2990274,-1
39,1,STEP,967765122378,967768304050,3181672,-1
40,1,STEP,967768413849,967771854319,3440470,-1
41,1,STEP,967771956018,967775389588,3433570,-1
42,1,STEP,967775481487,967779415353,3933866,-1
43,1,STEP,967779523852,967782746024,3222172,-1
44,1,STEP,967782825723,967786097494,3271771,-1
45,1,STEP,967786213293,967789822662,3609369,-1
46,1,STEP,967789931361,967793081533,3150172,-1
47,1,STEP,967793160232,967796293305,3133073,-1
48,1,STEP,967796374104,967799805574,3431470,-1
49,1,STEP,967799942973,967802903247,2960274,-1
50,1,STEP,967802972946,967806757813,3784867,-1
51,1,STEP,967806841212,967810679079,3837867,-1
52,1,STEP,967810775678,967814302347,3526669,-1
53,1,STEP,967814404646,967817460219,3055573,-1
54,1,STEP,967817568618,967821004188,3435570,-1
55,1,STEP,967821111087,967824712656,3601569,-1
56,1,STEP,967824819155,967828245425,3426270,-1
57,1,STEP,967828354024,967831245299,2891275,-1
58,1,STEP,967831354998,967834034774,2679776,-1
59,1,STEP,967834135673,967836798450,2662777,-1
60,1,STEP,967836890249,967839763424,2873175,-1
61,1,STEP,967839848623,967843152994,3304371,-1
62,1,STEP,967843238193,967846170768,2932575,-1
63,1,STEP,967846257567,967850464730,4207163,-1
64,1,STEP,967850550929,967854226797,3675868,-1
65,1,STEP,967854307696,967857975364,3667668,-1
66,1,STEP,967858058163,967860528742,2470579,-1
67,1,STEP,967860622341,967863703014,3080673,-1
68,1,STEP,967863783613,967866748187,2964574,-1
69,1,STEP,967866834287,967869578262,2743975,-1
70,1,STEP,967869662062,967872281239,2619177,-1
71,1,STEP,967872367138,967875397711,3030573,-1
72,1,STEP,967875479311,967878719282,3239971,-1
73,1,STEP,967878805682,967882285751,3480069,-1
74,1,STEP,967882368050,967885531123,3163073,-1
75,1,STEP,967885612022,967888750794,3138772,-1
76,1,STEP,967888832894,967891602969,2770075,-1
77,1,STEP,967891685469,967894625443,2939974,-1
78,1,STEP,967894724442,967897652616,2928174,-1
79,1,STEP,967897734916,967900540191,2805275,-1
80,1,STEP,967900623590,967903740263,3116673,-1
81,1,STEP,967903823062,967906571138,2748076,-1
82,1,STEP,967906654437,967909706111,3051674,-1
83,1,STEP,967909789210,967912693084,2903874,-1
84,1,STEP,967912775184,967915905056,3129872,-1
85,1,STEP,967916007955,967918937630,2929675,-1
86,1,STEP,967919020329,967922148302,3127973,-1
87,1,STEP,967922232101,967925281474,3049373,-1
88,1,STEP,967925364273,967928325447,2961174,-1
89,1,STEP,967928409247,967931234122,2824875,-1
90,1,STEP,967931316621,967934568993,3252372,-1
91,1,STEP,967934651992,967938009363,3357371,-1
92,1,STEP,967938092162,967941368033,3275871,-1
93,1,STEP,967941458032,967944085809,2627777,-1
94,1,STEP,967944171508,967946993884,2822376,-1
95,1,STEP,967947076783,967950316355,3239572,-1
96,1,STEP,967950397954,967953266629,2868675,-1
97,1,STEP,967953356628,967956184903,2828275,-1
98,1,STEP,967956268502,967959111378,2842876,-1
99,1,STEP,967959196577,967962293650,3097073,-1
100,1,STEP,967962377949,967964998526,2620577,-1
101,1,STEP,967965079425,967967967000,2887575,-1
102,1,STEP,967968049399,967971299171,3249772,-1
103,1,STEP,967971398770,967975383035,3984265,-1
104,1,STEP,967975506234,967979499599,3993365,-1
105,1,STEP,967979630698,967984405256,4774558,-1
106,1,STEP,967984513355,967988926716,4413361,-1
107,1,STEP,967989065315,967993078980,4013665,-1
108,1,STEP,967993214179,967998131135,4916956,-1
109,1,STEP,967998254034,968002638496,4384462,-1
110,1,STEP,968002767095,968007181056,4413961,-1
111,1,STEP,968007317255,968011777316,4460061,-1
112,1,STEP,968011894715,968015093687,3198972,-1
113,1,STEP,968015176086,968017846963,2670877,-1
114,1,STEP,968017948962,968021057834,3108872,-1
115,1,STEP,968021146934,968023926109,2779175,-1
116,1,STEP,968024018608,968027243780,3225172,-1
117,1,STEP,968027338479,968030569451,3230972,-1
118,1,STEP,968030657350,968034156620,3499270,-1
119,1,STEP,968034251519,968037704688,3453169,-1
120,1,STEP,968037795088,968041252557,3457469,-1
121,1,STEP,968041349457,968044801126,3451669,-1
122,1,STEP,968044892325,968048021698,3129373,-1
123,1,STEP,968048144997,968051235870,3090873,-1
124,1,STEP,968051359869,968054547441,3187572,-1
125,1,STEP,968054660840,968057505315,2844475,-1
126,1,STEP,968057617514,968060604388,2986874,-1
127,1,STEP,968060718587,968064315655,3597068,-1
128,1,STEP,968064452954,968067910824,3457870,-1
129,1,STEP,968068029423,968071580791,3551368,-1
130,1,STEP,968071675491,968075116160,3440669,-1
131,1,STEP,968075234559,968078325332,3090773,-1
132,1,STEP,968078406032,968081240407,2834375,-1
133,1,STEP,968081326806,968084244580,2917774,-1
134,1,STEP,968084326380,968087643051,3316671,-1
135,1,STEP,968087727550,968090843923,3116373,-1
136,1,STEP,968090925522,968093722197,2796675,-1
137,1,STEP,968093812497,968097404765,3592268,-1
138,1,STEP,968097500764,968100556837,3056073,-1
139,1,STEP,968100648637,968103622711,2974074,-1
140,1,STEP,968103719610,968106882082,3162472,-1
141,1,STEP,968106983781,968110207053,3223272,-1
142,1,STEP,968110302052,968114027819,3725767,-1
143,1,STEP,968114129318,968117200992,3071674,-1
144,1,STEP,968117296591,968119737469,2440878,-1
145,1,STEP,968119831768,968123576736,3744968,-1
146,1,STEP,968123686135,968126523410,2837275,-1
147,1,STEP,968126614909,968129434384,2819475,-1
148,1,STEP,968129532483,968132459758,2927275,-1
149,1,STEP,968132556657,968135972727,3416070,-1
150,1,STEP,968136071326,968139167799,3096473,-1
151,1,STEP,968139260398,968142674068,3413670,-1
152,1,STEP,968142778567,968145967339,3188772,-1
153,1,STEP,968146073038,968148887514,2814476,-1
154,1,STEP,968148984113,968152171485,3187372,-1
155,1,STEP,968152272484,968155638655,3366171,-1
156,1,STEP,968155747254,968158543429,2796175,-1
157,1,STEP,968158662428,968162226297,3563869,-1
158,1,STEP,968162333996,968166668958,4334962,-1
159,1,STEP,968166761857,968169917829,3155972,-1
160,1,STEP,968170005029,968173458398,3453369,-1
161,1,STEP,968173544598,968177504363,3959765,-1
162,1,STEP,968177633062,968181000932,3367870,-1
163,1,STEP,968181072332,968183953506,2881174,-1
164,1,STEP,968184022106,968187263477,3241371,-1
165,1,STEP,968187334777,968190383650,3048873,-1
166,1,STEP,968190454049,968193401723,2947674,-1
167,1,STEP,968193472423,968196467097,2994674,-1
168,1,STEP,968196535996,968199742068,3206072,-1
169,1,STEP,968199811667,968202633343,2821676,-1
170,1,STEP,968202703642,968205552017,2848375,-1
171,1,STEP,968205625916,968208605190,2979274,-1
172,1,STEP,968208675390,968211319166,2643776,-1
173,1,STEP,968211388566,968214485539,3096973,-1
174,1,STEP,968214556338,968217671911,3115573,-1
175,1,STEP,968217742910,968220659384,2916474,-1
176,1,STEP,968220750084,968224219753,3469669,-1
177,1,STEP,968224292453,968227428325,3135872,-1
178,1,STEP,968227499225,968230291300,2792075,-1
179,1,STEP,968230371399,968234259165,3887766,-1
180,1,STEP,968234339465,968237032541,2693076,-1
181,1,STEP,968237101540,968239790817,2689277,-1
182,1,STEP,968239859316,968242617092,2757776,-1
183,1,STEP,968242686891,968245560466,2873575,-1
184,1,STEP,968245629766,968248991936,3362170,-1
185,1,STEP,968249062635,968252295707,3233072,-1
186,1,STEP,968252366807,968254868185,2501378,-1
187,1,STEP,968254937084,968257860258,2923174,-1
188,1,STEP,968257972157,968260941431,2969274,-1
189,1,STEP,968261044430,968263612708,2568278,-1
190,1,STEP,968263714507,968266435983,2721476,-1
191,1,STEP,968266539382,968269555456,3016074,-1
192,1,STEP,968269665055,968272250132,2585077,-1
193,1,STEP,968272353631,968275221506,2867875,-1
194,1,STEP,968275333505,968278133081,2799576,-1
195,1,STEP,968278236880,968281150954,2914074,-1
196,1,STEP,968281259953,968284822822,3562869,-1
197,1,STEP,968284932821,968287719697,2786876,-1
198,1,STEP,968287830396,968290894969,3064573,-1
199,1,STEP,968291004368,968294169440,3165072,-1
200,1,STEP,968294282739,968297131014,2848275,-1
201,1,STEP,968297238613,968300222487,2983874,-1
202,1,STEP,968300334086,968303499158,3165072,-1
203,1,STEP,968303609157,968306451132,2841975,-1
204,1,STEP,968306562731,968309817203,3254472,-1
205,1,STEP,968309938302,968312945175,3006873,-1
206,1,STEP,968313055574,968316746442,3690868,-1
207,1,STEP,968316857041,968319887815,3030774,-1
208,1,STEP,968319998514,968322867388,2868874,-1
209,1,STEP,968322977687,968326133360,3155673,-1
210,1,STEP,968326245859,968328778037,2532178,-1
211,1,STEP,968328886936,968332039408,3152472,-1
212,1,STEP,968332153707,968335346279,3192572,-1
213,1,STEP,968335457478,968338998847,3541369,-1
214,1,STEP,968339109546,968342435917,3326371,-1
215,1,STEP,968342547116,968345340791,2793675,-1
216,1,STEP,968345450190,968348886460,3436270,-1
217,1,STEP,968348996759,968352049333,3052574,-1
218,1,STEP,968352159932,968355414103,3254171,-1
219,1,STEP,968355524702,968358383777,2859075,-1
220,1,STEP,968358493676,968361850347,3356671,-1
221,1,STEP,968361970046,968364921920,2951874,-1
222,1,STEP,968365033419,968368650287,3616868,-1
223,1,STEP,968368762686,968372234656,3471970,-1
224,1,STEP,968372349355,968375491827,3142472,-1
225,1,STEP,968375603226,968378735999,3132773,-1
226,1,STEP,968378854798,968381770172,2915374,-1
227,1,STEP,968381889671,968384888345,2998674,-1
228,1,STEP,968385001244,968387716820,2715576,-1
229,1,STEP,968387826819,968390784393,2957574,-1
230,1,STEP,968390896692,968394171063,3274371,-1
231,1,STEP,968394282162,968397329536,3047374,-1
232,1,STEP,968397439435,968399927513,2488078,-1
233,1,STEP,968400035012,968403129585,3094573,-1
234,1,STEP,968403242484,968405950760,2708276,-1
235,1,STEP,968406062659,968409902225,3839566,-1
236,1,STEP,968410017424,968412878399,2860975,-1
237,1,STEP,968412988398,968416484068,3495670,-1
238,1,STEP,968416595867,968419244043,2648176,-1
239,1,STEP,968419354243,968422480015,3125772,-1
240,1,STEP,968422600914,968425847786,3246872,-1
241,1,STEP,968425966385,968429102657,3136272,-1
242,1,STEP,968429224156,968432183330,2959174,-1
243,1,STEP,968432295029,968435438201,3143172,-1
244,1,STEP,968435559200,968438843272,3284072,-1
245,1,STEP,968438956571,968442655038,3698467,-1
246,1,STEP,968442770637,968445123817,2353180,-1
247,1,STEP,968445234216,968447904892,2670676,-1
248,1,STEP,968448016491,968450951865,2935374,-1
249,1,STEP,968451069364,968454173837,3104473,-1
250,1,STEP,968454288436,968457937504,3649068,-1
251,1,STEP,968458051703,968461152076,3100373,-1
252,1,STEP,968461265275,968464453247,3187972,-1
253,1,STEP,968464566046,968467219823,2653777,-1
254,1,STEP,968467331622,968470399495,3067873,-1
255,1,STEP,968470512094,968473572967,3060873,-1
256,1,STEP,968473729066,968476803839,3074773,-1
257,1,STEP,968476913938,968480266808,3352870,-1
258,1,STEP,968480381207,968483026284,2645077,-1
259,1,STEP,968483137483,968486369255,3231772,-1
260,1,STEP,968486485354,968490314820,3829466,-1
261,1,STEP,968490456519,968493938589,3482070,-1
262,1,STEP,968494013488,968496919462,2905974,-1
263,1,STEP,968496991462,968500824528,3833066,-1
264,1,STEP,968500897828,968503938801,3040973,-1
265,1,STEP,968504010300,968506493379,2483079,-1
266,1,STEP,968506565278,968509695650,3130372,-1
267,1,STEP,968509767050,968513228819,3461769,-1
268,1,STEP,968513301519,968515741397,2439878,-1
269,1,STEP,968515811097,968518858070,3046973,-1
270,1,STEP,968518930770,968522260440,3329670,-1
271,1,STEP,968522332640,968525589211,3256571,-1
272,1,STEP,968525661110,968528803783,3142673,-1
273,1,STEP,968528875982,968531250061,2374079,-1
274,1,STEP,968531320361,968534035937,2715576,-1
275,1,STEP,968534107836,968537302308,3194472,-1
276,1,STEP,968537373908,968540645979,3272071,-1
277,1,STEP,968540767178,968544210848,3443670,-1
278,1,STEP,968544285147,968547351220,3066073,-1
279,1,STEP,968547424720,968550465493,3040773,-1
280,1,STEP,968550537392,968553606365,3068973,-1
281,1,STEP,968553677865,968556203843,2525978,-1
282,1,STEP,968556270942,968559060718,2789776,-1
283,1,STEP,968559131017,968561937292,2806275,-1
284,1,STEP,968562007792,968565050765,3042973,-1
285,1,STEP,968565120965,968568198638,3077673,-1
286,1,STEP,968568268037,968571400109,3132072,-1
287,1,STEP,968571471309,968574323584,2852275,-1
288,1,STEP,968574392983,968577347657,2954674,-1
289,1,STEP,968577417457,968579785536,2368079,-1
290,1,STEP,968579854035,968582633711,2779676,-1
291,1,STEP,968582705510,968585383787,2678277,-1
292,1,STEP,968585453786,968588703058,3249272,-1
293,1,STEP,968588775057,968591864430,3089373,-1
294,1,STEP,968591937629,968594984003,3046374,-1
295,1,STEP,968595057102,968598419973,3362871,-1
296,1,STEP,968598492772,968601173248,2680476,-1
297,1,STEP,968601244648,968604124423,2879775,-1
298,1,STEP,968604193822,968607244295,3050473,-1
299,1,STEP,968607316495,968610074070,2757575,-1
300,1,STEP,968610146170,968613113344,2967174,-1
301,1,STEP,968613184243,968615613422,2429179,-1
302,1,STEP,968615681821,968618518896,2837075,-1
303,1,STEP,968618590696,968621474770,2884074,-1
304,1,STEP,968621545070,968624558543,3013473,-1
305,1,STEP,968624629443,968627623117,2993674,-1
306,1,STEP,968627695216,968630945187,3249971,-1
307,1,STEP,968631018387,968633670864,2652477,-1
308,1,STEP,968633742463,968636668437,2925974,-1
309,1,STEP,968636739737,968639174515,2434778,-1
310,1,STEP,968639244315,968642830783,3586468,-1
311,1,STEP,968642905083,968646068055,3162972,-1
312,1,STEP,968646140254,968649182628,3042374,-1
313,1,STEP,968649254427,968652253101,2998674,-1
314,1,STEP,968652326700,968655115176,2788476,-1
315,1,STEP,968655187775,968658158349,2970574,-1
316,1,STEP,968658232048,968661365221,3133173,-1
317,1,STEP,968661453820,968664209796,2755976,-1
318,1,STEP,968664294295,968667387468,3093173,-1
319,1,STEP,968667487167,968670715739,3228572,-1
320,1,STEP,968670806938,968673896811,3089873,-1
321,1,STEP,968673978910,968677265181,3286271,-1
322,1,STEP,968677347681,968680365754,3018073,-1
323,1,STEP,968680448353,968683912723,3464370,-1
324,1,STEP,968683995722,968686923597,2927875,-1
325,1,STEP,968687005696,968690332167,3326471,-1
326,1,STEP,968690405066,968693933735,3528669,-1
327,1,STEP,968694009235,968696898409,2889174,-1
328,1,STEP,968696971509,968699582286,2610777,-1
329,1,STEP,968699654485,968702626359,2971874,-1
330,1,STEP,968702699558,968705754532,3054974,-1
331,1,STEP,968705825631,968708829205,3003574,-1
332,1,STEP,968708902704,968711331483,2428779,-1
333,1,STEP,968711403582,968714530455,3126873,-1
334,1,STEP,968714602954,968717567928,2964974,-1
335,1,STEP,968717640027,968720336404,2696377,-1
336,1,STEP,968720410403,968723396977,2986574,-1
337,1,STEP,968723469576,968726338651,2869075,-1
338,1,STEP,968726410850,968729461324,3050474,-1
339,1,STEP,968729536223,968732338199,2801976,-1
340,1,STEP,968732410298,968735643770,3233472,-1
341,1,STEP,968735717569,968738923741,3206172,-1
342,1,STEP,968739030940,968742286111,3255171,-1
343,1,STEP,968742388210,968745588182,3199972,-1
344,1,STEP,968745658582,968748817454,3158872,-1
345,1,STEP,968748891253,968751723029,2831776,-1
346,1,STEP,968751794228,968754712902,2918674,-1
347,1,STEP,968754785502,968757769076,2983574,-1
348,1,STEP,968757841275,968761178046,3336771,-1
349,1,STEP,968761252845,968764485817,3232972,-1
350,1,STEP,968764560916,968767554990,2994074,-1
351,1,STEP,968767628389,968770606863,2978474,-1
352,1,STEP,968770678962,968773897734,3218772,-1
353,1,STEP,968773970234,968776860708,2890474,-1
354,1,STEP,968776931408,968779841682,2910274,-1
355,1,STEP,968779930681,968783483550,3552869,-1
356,1,STEP,968783578749,968786622723,3043974,-1
357,1,STEP,968786709422,968789760095,3050673,-1
358,1,STEP,968789848894,968792668470,2819576,-1
359,1,STEP,968792753369,968795796142,3042773,-1
360,1,STEP,968795880641,968799298111,3417470,-1
361,1,STEP,968799383711,968802403984,3020273,-1
362,1,STEP,968802491683,968805110061,2618378,-1
363,1,STEP,968805191260,968807705638,2514378,-1
364,1,STEP,968807789937,968810746711,2956774,-1
365,1,STEP,968810837710,968814159781,3322071,-1
366,1,STEP,968814254980,968818120146,3865166,-1
367,1,STEP,968818254945,968821220119,2965174,-1
368,1,STEP,968821298019,968824088494,2790475,-1
369,1,STEP,968824162193,968827086468,2924275,-1
370,1,STEP,968827164467,968829557546,2393079,-1
371,1,STEP,968829630146,968832777918,3147772,-1
372,1,STEP,968832850617,968836029089,3178472,-1
373,1,STEP,968836108089,968838931764,2823675,-1
374,1,STEP,968839010163,968841853338,2843175,-1
375,1,STEP,968841946938,968844747613,2800675,-1
376,1,STEP,968844824712,968847510489,2685777,-1
377,1,STEP,968847583888,968850502763,2918875,-1
378,1,STEP,968850575762,968853246039,2670277,-1
379,1,STEP,968853319138,968856201813,2882675,-1
380,1,STEP,968856273112,968859331385,3058273,-1
381,1,STEP,968859405885,968861972662,2566777,-1
382,1,STEP,968862046561,968865262333,3215772,-1
383,1,STEP,968865336333,968868231307,2894974,-1
384,1,STEP,968868304606,968871406679,3102073,-1
385,1,STEP,968871481779,968874425153,2943374,-1
386,1,STEP,968874498952,968877652525,3153573,-1
387,1,STEP,968877725824,968880732398,3006574,-1
388,1,STEP,968880806497,968883916170,3109673,-1
389,1,STEP,968884029069,968886773445,2744376,-1
390,1,STEP,968886889344,968890027216,3137872,-1
391,1,STEP,968890142315,968893179488,3037173,-1
392,1,STEP,968893294487,968896483059,3188572,-1
393,1,STEP,968896597958,968899712731,3114773,-1
394,1,STEP,968899829830,968902913903,3084073,-1
395,1,STEP,968903028102,968906455672,3427570,-1
396,1,STEP,968906570671,968909599844,3029173,-1
397,1,STEP,968909713443,968912492319,2778876,-1
398,1,STEP,968912606318,968916074788,3468470,-1
399,1,STEP,968916194087,968919830955,3636868,-1
400,1,STEP,968919948154,968923066826,3118672,-1
401,1,STEP,968923184325,968926019800,2835475,-1
402,1,STEP,968926134899,968928508979,2374080,-1
403,1,STEP,968928627078,968931730350,3103272,-1
404,1,STEP,968931847849,968934564826,2716977,-1
405,1,STEP,968934680725,968937596799,2916074,-1
406,1,STEP,968937711398,968940498674,2787276,-1
407,1,STEP,968940610273,968943841944,3231671,-1
408,1,STEP,968943948643,968947222415,3273772,-1
409,1,STEP,968947327914,968950730584,3402670,-1
410,1,STEP,968950845483,968953691258,2845775,-1
411,1,STEP,968953803357,968957070828,3267471,-1
412,1,STEP,968957179727,968959890804,2711077,-1
413,1,STEP,968960002603,968963482172,3479569,-1
414,1,STEP,968963596571,968966509446,2912875,-1
415,1,STEP,968966624645,968969047323,2422678,-1
416,1,STEP,968969161322,968972284495,3123173,-1
417,1,STEP,968972401094,968975076970,2675876,-1
418,1,STEP,968975193869,968978218843,3024974,-1
419,1,STEP,968978332942,968981366915,3033973,-1
420,1,STEP,968981481814,968984227990,2746176,-1
421,1,STEP,968984341189,968987182164,2840975,-1
422,1,STEP,968987299863,968990722933,3423070,-1
423,1,STEP,968990837632,968993949805,3112173,-1
424,1,STEP,968994066004,968996832180,2766176,-1
425,1,STEP,968996944579,968999926353,2981774,-1
426,1,STEP,969000041352,969003349123,3307771,-1
427,1,STEP,969003479221,969006027899,2548678,-1
428,1,STEP,969006138798,969009676167,3537369,-1
429,1,STEP,969009784066,969012885639,3101573,-1
430,1,STEP,969012996738,969015816313,2819575,-1
431,1,STEP,969015931512,969018999585,3068073,-1
432,1,STEP,969019113784,969021862560,2748776,-1
433,1,STEP,969021990359,969025441329,3450970,-1
434,1,STEP,969025553328,969028269204,2715876,-1
435,1,STEP,969028376503,969031662974,3286471,-1
436,1,STEP,969031774773,969034618548,2843775,-1
437,1,STEP,969034731947,969037826520,3094573,-1
438,1,STEP,969037945319,969041406889,3461570,-1
439,1,STEP,969041515288,969044671660,3156372,-1
440,1,STEP,969044777659,969047724733,2947074,-1
441,1,STEP,969047841132,969050649408,2808276,-1
442,1,STEP,969050764207,969054250976,3486769,-1
443,1,STEP,969054367175,969058050243,3683068,-1
444,1,STEP,969058164742,969061419913,3255171,-1
445,1,STEP,969061534812,969064032191,2497379,-1
446,1,STEP,969064144190,969067501960,3357770,-1
447,1,STEP,969067613959,969070417635,2803676,-1
448,1,STEP,969070532534,969073395608,2863074,-1
449,1,STEP,969073510107,969076293783,2783676,-1
450,1,STEP,969076406782,969079202758,2795976,-1
451,1,STEP,969079318557,969082424129,3105572,-1
452,1,STEP,969082537928,969085725500,3187572,-1
453,1,STEP,969085843399,969088857773,3014374,-1
454,1,STEP,969088976872,969092030045,3053173,-1
455,1,STEP,969092144044,969095261317,3117273,-1
456,1,STEP,969095379616,969098334590,2954974,-1
457,1,STEP,969098449389,969101417263,2967874,-1
458,1,STEP,969101531762,969104529435,2997673,-1
459,1,STEP,969104644534,969107877506,3232972,-1
460,1,STEP,969107992505,969111068578,3076073,-1
461,1,STEP,969111185477,969114467348,3281871,-1
462,1,STEP,969114577947,969117751720,3173773,-1
463,1,STEP,969117876418,969121240489,3364071,-1
464,1,STEP,969121353688,969124703059,3349371,-1
465,1,STEP,969124817758,969128396626,3578868,-1
466,1,STEP,969128514725,969131875596,3360871,-1
467,1,STEP,969131992495,969135259166,3266671,-1
468,1,STEP,969135373265,969138838235,3464970,-1
469,1,STEP,969138954534,969142345204,3390670,-1
470,1,STEP,969142458803,969146169770,3710967,-1
471,1,STEP,969146277869,969149316443,3038574,-1
472,1,STEP,969149389042,969153053510,3664468,-1
473,1,STEP,969153127609,969156483580,3355971,-1
474,1,STEP,969156559079,969160255447,3696368,-1
475,1,STEP,969160329346,969163422519,3093173,-1
476,1,STEP,969163549518,969166865289,3315771,-1
477,1,STEP,969166944788,969170138360,3193572,-1
478,1,STEP,969170212260,969173707429,3495169,-1
479,1,STEP,969173780528,969176801002,3020474,-1
480,1,STEP,969176873901,969179769476,2895575,-1
481,1,STEP,969179841575,969182871949,3030374,-1
482,1,STEP,969182944848,969185401726,2456878,-1
483,1,STEP,969185471926,969188441000,2969074,-1
484,1,STEP,969188511599,969191402374,2890775,-1
485,1,STEP,969191475573,969194865543,3389970,-1
486,1,STEP,969194938143,969197655419,2717276,-1
487,1,STEP,969197725518,969200551094,2825576,-1
488,1,STEP,969200621693,969204022863,3401170,-1
489,1,STEP,969204095963,969207293135,3197172,-1
490,1,STEP,969207364934,969210283508,2918574,-1
491,1,STEP,969210356308,969213330682,2974374,-1
492,1,STEP,969213399681,969216829751,3430070,-1
493,1,STEP,969216905050,969219891524,2986474,-1
494,1,STEP,969219983623,969222858498,2874875,-1
495,1,STEP,969222977197,969226023170,3045973,-1
496,1,STEP,969226097970,969229091943,2993973,-1
497,1,STEP,969229204142,969232619412,3415270,-1
498,1,STEP,969232716112,969238666259,5950147,-1
499,1,STEP,969238814058,969243799014,4984956,-1
500,1,STEP,969243891114,969247287584,3396470,-1
501,1,STEP,969247401883,969250506656,3104773,-1
502,1,STEP,969250582955,969253621828,3038873,-1
503,1,STEP,969253696528,969256832800,3136272,-1
504,1,STEP,969256906900,969259924273,3017373,-1
505,1,STEP,969259998872,969262984246,2985374,-1
506,1,STEP,969263058546,969265814121,2755575,-1
507,1,STEP,969265907021,969268934794,3027773,-1
508,1,STEP,969269009793,969272048667,3038874,-1
509,1,STEP,969272121066,969275278738,3157672,-1
510,1,STEP,969275371238,969278871107,3499869,-1
511,1,STEP,969279005106,969282988771,3983665,-1
512,1,STEP,969283128270,969286508140,3379870,-1
513,1,STEP,969286612439,969289423714,2811275,-1
514,1,STEP,969289516714,969292661886,3145172,-1
515,1,STEP,969292773485,969295666060,2892575,-1
516,1,STEP,969295779559,969299133529,3353970,-1
517,1,STEP,969299232928,969302548599,3315671,-1
518,1,STEP,969302661398,969306521565,3860167,-1
519,1,STEP,969306616564,969309938135,3321571,-1
520,1,STEP,969310034634,969313853900,3819266,-1
521,1,STEP,969313974799,969317491168,3516369,-1
522,1,STEP,969317594768,969321018937,3424169,-1
523,1,STEP,969321113037,969324427708,3314671,-1
524,1,STEP,969324515107,969327811578,3296471,-1
525,1,STEP,969327901677,969331378847,3477170,-1
526,1,STEP,969331466146,969334566519,3100373,-1
527,1,STEP,969334653118,969337483293,2830175,-1
528,1,STEP,969337569892,969341716156,4146264,-1
529,1,STEP,969341858755,969346053518,4194763,-1
530,1,STEP,969346131117,969350212382,4081265,-1
531,1,STEP,969350317481,969353665051,3347570,-1
532,1,STEP,969353763050,969356591426,2828376,-1
533,1,STEP,969356672725,969359908797,3236072,-1
534,1,STEP,969359997996,969363351066,3353070,-1
535,1,STEP,969363448066,969366761236,3313170,-1
536,1,STEP,969366853036,969370150207,3297171,-1
537,1,STEP,969370259606,969373485478,3225872,-1
538,1,STEP,969373597777,969377701941,4104164,-1
539,1,STEP,969377794340,969380435117,2640777,-1
540,1,STEP,969380527416,969383677588,3150172,-1
541,1,STEP,969383790887,969388427547,4636660,-1
542,1,STEP,969388513946,969390808326,2294380,-1
543,1,STEP,969390888825,969393955398,3066573,-1
544,1,STEP,969394038697,969396932772,2894075,-1
545,1,STEP,969397014471,969400377042,3362571,-1
546,1,STEP,969400459241,969403167617,2708376,-1
547,1,STEP,969403255617,969406552488,3296871,-1
548,1,STEP,969406636587,969410107956,3471369,-1
549,1,STEP,969410192956,969413268829,3075873,-1
550,1,STEP,969413349428,969416512300,3162872,-1
551,1,STEP,969416593800,969419568773,2974973,-1
552,1,STEP,969419650073,969422863045,3212972,-1
553,1,STEP,969422969444,969426128716,3159272,-1
554,1,STEP,969426201515,969431274171,5072656,-1
555,1,STEP,969431395870,969435181837,3785967,-1
556,1,STEP,969435275936,969438233610,2957674,-1
557,1,STEP,969438328909,969441180684,2851775,-1
558,1,STEP,969441274083,969444753853,3479770,-1
559,1,STEP,969444846652,969447765926,2919274,-1
560,1,STEP,969447869125,969450589902,2720777,-1
561,1,STEP,969450683601,969453320178,2636577,-1
562,1,STEP,969453411677,969456202052,2790375,-1
563,1,STEP,969456293552,969459596923,3303371,-1
564,1,STEP,969459688322,969463253690,3565368,-1
565,1,STEP,969463347090,969466661861,3314771,-1
566,1,STEP,969466754860,969469735734,2980874,-1
567,1,STEP,969469828033,969473090804,3262771,-1
568,1,STEP,969473184603,969476073478,2888875,-1
569,1,STEP,969476164377,969479292150,3127773,-1
570,1,STEP,969479383549,969482812819,3429270,-1
571,1,STEP,969482908118,969486326988,3418870,-1
572,1,STEP,969486422387,969489355262,2932875,-1
573,1,STEP,969489448261,969492762332,3314071,-1
574,1,STEP,969492905631,969498079985,5174354,-1
575,1,STEP,969498223984,969502723044,4499060,-1
576,1,STEP,969502815644,969505768618,2952974,-1
577,1,STEP,969505840017,969508938890,3098873,-1
578,1,STEP,969509012089,969512194961,3182872,-1
579,1,STEP,969512268261,969515400233,3131972,-1
580,1,STEP,969515473233,969518671505,3198272,-1
581,1,STEP,969518747104,969521600479,2853375,-1
582,1,STEP,969521674678,969524982449,3307771,-1
583,1,STEP,969525056449,969527705325,2648876,-1
584,1,STEP,969527776225,969530673499,2897274,-1
585,1,STEP,969530746299,969533831272,3084973,-1
586,1,STEP,969533921471,969537167442,3245971,-1
587,1,STEP,969537240242,969540520513,3280271,-1
588,1,STEP,969540633612,969544099482,3465870,-1
589,1,STEP,969544210481,969547192355,2981874,-1
590,1,STEP,969547303754,969550529425,3225671,-1
591,1,STEP,969550640124,969553864696,3224572,-1
592,1,STEP,969553995395,969557620063,3624668,-1
593,1,STEP,969557732062,969560737436,3005374,-1
594,1,STEP,969560847235,969563458212,2610977,-1
595,1,STEP,969563567911,969566465786,2897875,-1
596,1,STEP,969566580685,969569229061,2648376,-1
597,1,STEP,969569344360,969572220135,2875775,-1
598,1,STEP,969572347834,969575126310,2778476,-1
599,1,STEP,969575233709,969578657079,3423370,-1
600,1,STEP,969578766278,969581997649,3231371,-1
601,1,STEP,969582107348,969585413919,3306571,-1
602,1,STEP,969585521619,969588532992,3011373,-1
603,1,STEP,969588643091,969591766864,3123773,-1
604,1,STEP,969591889063,969594680738,2791675,-1
605,1,STEP,969594790537,969598305706,3515169,-1
606,1,STEP,969598424205,969601284980,2860775,-1
607,1,STEP,969601394279,969604470552,3076273,-1
608,1,STEP,969604580151,969607586425,3006274,-1
609,1,STEP,969607698224,969610742297,3044073,-1
610,1,STEP,969610854596,969614014469,3159873,-1
611,1,STEP,969614124468,969616785944,2661476,-1
612,1,STEP,969616892944,969619763918,2870974,-1
613,1,STEP,969619874917,969622573994,2699077,-1
614,1,STEP,969622680193,969625978964,3298771,-1
615,1,STEP,969626088763,969629074937,2986174,-1
616,1,STEP,969629181336,969632059411,2878075,-1
617,1,STEP,969632172010,969634789287,2617277,-1
618,1,STEP,969634897686,969637990559,3092873,-1
619,1,STEP,969638101158,969641273430,3172272,-1
620,1,STEP,969641384829,969644463702,3078873,-1
621,1,STEP,969644572601,969647361576,2788975,-1
622,1,STEP,969647475575,969650304951,2829376,-1
623,1,STEP,969650413950,969653526122,3112172,-1
624,1,STEP,969653637021,969656959292,3322271,-1
625,1,STEP,969657073691,969660488961,3415270,-1
626,1,STEP,969660606160,969663546435,2940275,-1
627,1,STEP,969663658634,969666946805,3288171,-1
628,1,STEP,969667057304,969670301175,3243871,-1
629,1,STEP,969670413574,969673467248,3053674,-1
630,1,STEP,969673581747,969677139815,3558068,-1
631,1,STEP,969677252014,969680175689,2923675,-1
632,1,STEP,969680285288,969683292161,3006873,-1
633,1,STEP,969683397460,969686461034,3063574,-1
634,1,STEP,969686574033,969689547307,2973274,-1
635,1,STEP,969689655506,969692581380,2925874,-1
636,1,STEP,969692691679,969695197657,2505978,-1
637,1,STEP,969695301256,969698827125,3525869,-1
638,1,STEP,969698939724,969702145996,3206272,-1
639,1,STEP,969702259195,969705010271,2751076,-1
640,1,STEP,969705123070,969708064444,2941374,-1
641,1,STEP,969708177443,969711263416,3085973,-1
642,1,STEP,969711375215,969714326589,2951374,-1
643,1,STEP,969714434288,969717360363,2926075,-1
644,1,STEP,969717472062,969720727933,3255871,-1
645,1,STEP,969720837432,969723922205,3084773,-1
646,1,STEP,969724034404,969727145577,3111173,-1
647,1,STEP,969727260076,969730765345,3505269,-1
648,1,STEP,969730853944,969733922518,3068574,-1
649,1,STEP,969734005017,969737588485,3583468,-1
650,1,STEP,969737671285,969740663358,2992073,-1
651,1,STEP,969740751158,969743537033,2785875,-1
652,1,STEP,969743618632,969746840304,3221672,-1
653,1,STEP,969746935503,969749995677,3060174,-1
654,1,STEP,969750107076,969753967642,3860566,-1
655,1,STEP,969754071841,969757647410,3575569,-1
656,1,STEP,969757741109,969761108379,3367270,-1
657,1,STEP,969761200478,969764415850,3215372,-1
658,1,STEP,969764510649,969767502023,2991374,-1
659,1,STEP,969767601622,969771395389,3793767,-1
660,1,STEP,969771504688,969775075957,3571269,-1
661,1,STEP,969775171556,969778554426,3382870,-1
662,1,STEP,969778637825,969781735498,3097673,-1
663,1,STEP,969781831097,969785148968,3317871,-1
664,1,STEP,969785239868,969788435940,3196072,-1
665,1,STEP,969788530139,969792486004,3955865,-1
666,1,STEP,969792583903,969795773875,3189972,-1
667,1,STEP,969795865774,969798928048,3062274,-1
668,1,STEP,969799016947,969801832522,2815575,-1
669,1,STEP,969801934321,969804501499,2567178,-1
670,1,STEP,969804590798,969808388965,3798167,-1
671,1,STEP,969808478764,969811860434,3381670,-1
672,1,STEP,969811947333,969815214305,3266972,-1
673,1,STEP,969815304504,969818154779,2850275,-1
674,1,STEP,969818250078,969821145253,2895175,-1
675,1,STEP,969821234452,969824532323,3297871,-1
676,1,STEP,969824621522,969827495397,2873875,-1
677,1,STEP,969827576596,969831000766,3424170,-1
678,1,STEP,969831091266,969833648043,2556777,-1
679,1,STEP,969833735942,969837012614,3276672,-1
680,1,STEP,969837117813,969840748381,3630568,-1
681,1,STEP,969840837880,969844094252,3256372,-1
682,1,STEP,969844182251,969847669020,3486769,-1
683,1,STEP,969847771919,969851032091,3260172,-1
684,1,STEP,969851124590,969854165163,3040573,-1
685,1,STEP,969854261762,969857740632,3478870,-1
686,1,STEP,969857822731,969860709406,2886675,-1
687,1,STEP,969860803805,969864282375,3478570,-1
688,1,STEP,969864367274,969867291248,2923974,-1
689,1,STEP,969867380047,969870920716,3540669,-1
690,1,STEP,969871032215,969874043989,3011774,-1
691,1,STEP,969874156588,969877306860,3150272,-1
692,1,STEP,969877433159,969881331525,3898366,-1
693,1,STEP,969881446524,969884140401,2693877,-1
694,1,STEP,969884253100,969887101275,2848175,-1
695,1,STEP,969887214674,969890026149,2811475,-1
696,1,STEP,969890140648,969892732725,2592077,-1
697,1,STEP,969892843824,969895609100,2765276,-1
698,1,STEP,969895719899,969898814772,3094873,-1
699,1,STEP,969898928771,969902171842,3243071,-1
700,1,STEP,969902285441,969905743411,3457970,-1
701,1,STEP,969905866010,969908931383,3065373,-1
702,1,STEP,969909004483,969912317453,3312970,-1
703,1,STEP,969912390853,969915087729,2696876,-1
704,1,STEP,969915160829,969918219602,3058773,-1
705,1,STEP,969918293601,969920865079,2571478,-1
706,1,STEP,969920937378,969923580155,2642777,-1
707,1,STEP,969923651454,969926794027,3142573,-1
708,1,STEP,969926864926,969929949399,3084473,-1
709,1,STEP,969930025198,969933119971,3094773,-1
710,1,STEP,969933191770,969936421442,3229672,-1
711,1,STEP,969936495242,969939151418,2656176,-1
712,1,STEP,969939222418,969942213191,2990773,-1
713,1,STEP,969942285791,969945995458,3709667,-1
714,1,STEP,969946068558,969948970232,2901674,-1
715,1,STEP,969949040532,969952177804,3137272,-1
716,1,STEP,969952250803,969955295577,3044774,-1
717,1,STEP,969955369076,969958107052,2737976,-1
718,1,STEP,969958178451,969960831428,2652977,-1
719,1,STEP,969960903928,969963951001,3047073,-1
720,1,STEP,969964023200,969967335071,3311871,-1
721,1,STEP,969967406371,969970295645,2889274,-1
722,1,STEP,969970365845,969973863514,3497669,-1
723,1,STEP,969973957513,969976919987,2962474,-1
724,1,STEP,969976990486,969980409457,3418971,-1
725,1,STEP,969980482956,969983761527,3278571,-1
726,1,STEP,969983867126,969987133998,3266872,-1
727,1,STEP,969987247097,969990586367,3339270,-1
728,1,STEP,969990702266,969993721340,3019074,-1
729,1,STEP,969993835839,969997339508,3503669,-1
730,1,STEP,969997455007,970001156775,3701768,-1
731,1,STEP,970001271474,970004460546,3189072,-1
732,1,STEP,970004574145,970007313821,2739676,-1
733,1,STEP,970007425420,970010310794,2885374,-1
734,1,STEP,970010425793,970013004371,2578578,-1
735,1,STEP,970013122170,970015835446,2713276,-1
736,1,STEP,970015952345,970018985218,3032873,-1
737,1,STEP,970019094417,970021850893,2756476,-1
738,1,STEP,970021972192,970024814467,2842275,-1
739,1,STEP,970024930666,970028071439,3140773,-1
740,1,STEP,970028185538,970030950613,2765075,-1
741,1,STEP,970031060612,970033900688,2840076,-1
742,1,STEP,970034011387,970037150559,3139172,-1
743,1,STEP,970037260158,970040947826,3687668,-1
744,1,STEP,970041062225,970044064898,3002673,-1
745,1,STEP,970044177797,970047574568,3396771,-1
746,1,STEP,970047690267,970050803739,3113472,-1
747,1,STEP,970050922538,970053499216,2576678,-1
748,1,STEP,970053614515,970056792687,3178172,-1
749,1,STEP,970056907486,970059380464,2472978,-1
750,1,STEP,970059496563,970062665435,3168872,-1
751,1,STEP,970062778434,970066001106,3222672,-1
752,1,STEP,970066111605,970069082779,2971174,-1
753,1,STEP,970069195678,970071774856,2579178,-1
754,1,STEP,970071892054,970075200325,3308271,-1
755,1,STEP,970075314224,970077974001,2659777,-1
756,1,STEP,970078084700,970081106174,3021474,-1
757,1,STEP,970081218473,970084031548,2813075,-1
758,1,STEP,970084147047,970087406618,3259571,-1
759,1,STEP,970087522217,970090930988,3408771,-1
760,1,STEP,970091047787,970093658564,2610777,-1
761,1,STEP,970093774063,970097108133,3334070,-1
762,1,STEP,970097224532,970100205606,2981074,-1
763,1,STEP,970100318605,970103180580,2861975,-1
764,1,STEP,970103296779,970106067655,2770876,-1
765,1,STEP,970106180954,970109012829,2831875,-1
766,1,STEP,970109129428,970112249001,3119573,-1
767,1,STEP,970112362000,970115810069,3448069,-1
768,1,STEP,970115935968,970118764344,2828376,-1
769,1,STEP,970118883742,970121287521,2403779,-1
770,1,STEP,970121401120,970124710691,3309571,-1
771,1,STEP,970124825190,970127913763,3088573,-1
772,1,STEP,970128029062,970130953037,2923975,-1
773,1,STEP,970131066536,970134675304,3608768,-1
774,1,STEP,970134792203,970137912076,3119873,-1
775,1,STEP,970138024775,970141125048,3100273,-1
776,1,STEP,970141235947,970144531318,3295371,-1
777,1,STEP,970144642617,970147508192,2865575,-1
778,1,STEP,970147622191,970150640864,3018673,-1
779,1,STEP,970150754263,970153979635,3225372,-1
780,1,STEP,970154095234,970156732611,2637377,-1
781,1,STEP,970156843210,970159205089,2361879,-1
782,1,STEP,970159318488,970162423261,3104773,-1
783,1,STEP,970162538360,970165389935,2851575,-1
784,1,STEP,970165501534,970168230610,2729076,-1
785,1,STEP,970168344509,970171475781,3131272,-1
786,1,STEP,970171611380,970174703753,3092373,-1
787,1,STEP,970174821252,970177448029,2626777,-1
788,1,STEP,970177560428,970180976598,3416170,-1
789,1,STEP,970181089297,970184237770,3148473,-1
790,1,STEP,970184351169,970187801338,3450169,-1
791,1,STEP,970187920737,970191134709,3213972,-1
792,1,STEP,970191248308,970194531279,3282971,-1
793,1,STEP,970194651478,970197801751,3150273,-1
794,1,STEP,970197923550,970201359819,3436269,-1
795,1,STEP,970201473718,970204617991,3144273,-1
796,1,STEP,970204731390,970208164660,3433270,-1
797,1,STEP,970208277659,970210936935,2659276,-1
798,1,STEP,970211054734,970214355805,3301071,-1
799,1,STEP,970214467804,970217528578,3060774,-1
800,1,STEP,970217642877,970220551551,2908674,-1
801,1,STEP,970220665750,970224050420,3384670,-1
802,1,STEP,970224167019,970226749597,2582578,-1
803,1,STEP,970226863496,970230542264,3678768,-1
804,1,STEP,970230659663,970234268331,3608668,-1
805,1,STEP,970234383030,970237060506,2677476,-1
806,1,STEP,970237170905,970240497876,3326971,-1
807,1,STEP,970240615975,970243734148,3118173,-1
808,1,STEP,970243845447,970246615523,2770076,-1
809,1,STEP,970246728822,970249624396,2895574,-1
810,1,STEP,970249736295,970252350672,2614377,-1
811,1,STEP,970252465571,970255577644,3112073,-1
812,1,STEP,970255691443,970259121413,3429970,-1
813,1,STEP,970259235912,970262227086,2991174,-1
814,1,STEP,970262344885,970265246159,2901274,-1
815,1,STEP,970265361258,970269117025,3755767,-1
816,1,STEP,970269232924,970272978692,3745768,-1
817,1,STEP,970273094391,970276397262,3302871,-1
818,1,STEP,970276511561,970279641433,3129872,-1
819,1,STEP,970279762532,970282849605,3087073,-1
820,1,STEP,970282969004,970285752080,2783076,-1
821,1,STEP,970285863179,970289014551,3151372,-1
822,1,STEP,970289128750,970291966525,2837775,-1
823,1,STEP,970292081924,970295267696,3185772,-1
824,1,STEP,970295380595,970297901273,2520678,-1
825,1,STEP,970298013972,970300786748,2772776,-1
826,1,STEP,970300897147,970304172918,3275771,-1
827,1,STEP,970304287717,970306840995,2553278,-1
828,1,STEP,970306952594,970309864768,2912174,-1
829,1,STEP,970309985967,970312949741,2963774,-1
830,1,STEP,970313063140,970315787116,2723976,-1
831,1,STEP,970315900015,970318702691,2802676,-1
832,1,STEP,970318811690,970321959862,3148172,-1
833,1,STEP,970322070861,970324792637,2721776,-1
834,1,STEP,970324904136,970328209507,3305371,-1
835,1,STEP,970328313506,970331456579,3143073,-1
836,1,STEP,970331530378,970335006548,3476170,-1
837,1,STEP,970335080347,970338062721,2982374,-1
838,1,STEP,970338135720,970340879996,2744276,-1
839,1,STEP,970340952396,970343627072,2674676,-1
840,1,STEP,970343700771,970346625646,2924875,-1
841,1,STEP,970346697745,970349600720,2902975,-1
842,1,STEP,970349672219,970352467795,2795576,-1
843,1,STEP,970352538794,970355773866,3235072,-1
844,1,STEP,970355846765,970359044537,3197772,-1
845,1,STEP,970359114536,970362344808,3230272,-1
846,1,STEP,970362416507,970365774178,3357671,-1
847,1,STEP,970365846977,970369160748,3313771,-1
848,1,STEP,970369232948,970372483519,3250571,-1
849,1,STEP,970372556019,970376088588,3532569,-1
850,1,STEP,970376162587,970378945563,2782976,-1
851,1,STEP,970379018062,970382280633,3262571,-1
852,1,STEP,970382352433,970385936901,3584468,-1
853,1,STEP,970386010201,970389287872,3277671,-1
854,1,STEP,970389370871,970392103147,2732276,-1
855,1,STEP,970392173947,970395043121,2869174,-1
856,1,STEP,970395115521,970397937896,2822375,-1
857,1,STEP,970398008995,970401069769,3060774,-1
858,1,STEP,970401142568,970404551238,3408670,-1
859,1,STEP,970404625937,970408086207,3460270,-1
860,1,STEP,970408176206,970411616376,3440170,-1
861,1,STEP,970411687875,970414855648,3167773,-1
862,1,STEP,970414933247,970418294418,3361171,-1
863,1,STEP,970418373917,970421733687,3359770,-1
864,1,STEP,970421820687,970425024759,3204072,-1
865,1,STEP,970425109958,970428215731,3105773,-1
866,1,STEP,970428303530,970431096705,2793175,-1
867,1,STEP,970431184705,970434261278,3076573,-1
868,1,STEP,970434344877,970437379350,3034473,-1
869,1,STEP,970437462949,970440925419,3462470,-1
870,1,STEP,970441014418,970444086191,3071773,-1
871,1,STEP,970444169791,970446920967,2751176,-1
872,1,STEP,970447004766,970450200838,3196072,-1
873,1,STEP,970450283537,970453276411,2992874,-1
874,1,STEP,970453363710,970456232985,2869275,-1
875,1,STEP,970456322184,970459433757,3111573,-1
876,1,STEP,970459523956,970462512830,2988874,-1
877,1,STEP,970462596929,970465465904,2868975,-1
878,1,STEP,970465549603,970468938174,3388571,-1
879,1,STEP,970469026173,970471993247,2967074,-1
880,1,STEP,970472077046,970475553216,3476170,-1
881,1,STEP,970475638915,970478393291,2754376,-1
882,1,STEP,970478476990,970481086167,2609177,-1
883,1,STEP,970481170266,970484008741,2838475,-1
884,1,STEP,970484094341,970486731318,2636977,-1
885,1,STEP,970486817717,970490216087,3398370,-1
886,1,STEP,970490301786,970493236360,2934574,-1
887,1,STEP,970493321060,970496425333,3104273,-1
888,1,STEP,970496509632,970499244608,2734976,-1
889,1,STEP,970499327407,970502673778,3346371,-1
890,1,STEP,970502765377,970505791650,3026273,-1
891,1,STEP,970505883550,970509409919,3526369,-1
892,1,STEP,970509499918,970513169086,3669168,-1
893,1,STEP,970513271385,970515879762,2608377,-1
894,1,STEP,970515965561,970518969535,3003974,-1
895,1,STEP,970519063534,970521774610,2711076,-1
896,1,STEP,970521855410,970525056382,3200972,-1
897,1,STEP,970525137481,970528365653,3228172,-1
898,1,STEP,970528450952,970531196328,2745376,-1
899,1,STEP,970531280927,970534894395,3613468,-1
900,1,STEP,970535000794,970537696171,2695377,-1
901,1,STEP,970537792270,970541084141,3291871,-1
902,1,STEP,970541181140,970544225813,3044673,-1
903,1,STEP,970544324013,970547545484,3221471,-1
904,1,STEP,970547651383,970550990654,3339271,-1
905,1,STEP,970551083853,970553983528,2899675,-1
906,1,STEP,970554084827,970557126800,3041973,-1
907,1,STEP,970557230699,970560553570,3322871,-1
908,1,STEP,970560654669,970563548944,2894275,-1
909,1,STEP,970563644343,970566423119,2778776,-1
910,1,STEP,970566519318,970569314394,2795076,-1
911,1,STEP,970569407693,970572971061,3563368,-1
912,1,STEP,970573073461,970575665138,2591677,-1
913,1,STEP,970575761837,970578944209,3182372,-1
914,1,STEP,970579046808,970582250380,3203572,-1
915,1,STEP,970582359379,970585542251,3182872,-1
916,1,STEP,970585651250,970588433126,2781876,-1
917,1,STEP,970588529225,970591427900,2898675,-1
918,1,STEP,970591537999,970594574472,3036473,-1
919,1,STEP,970594647571,970597948642,3301071,-1
920,1,STEP,970598022542,970601609110,3586568,-1
921,1,STEP,970601695410,970605088080,3392670,-1
922,1,STEP,970605162779,970607887755,2724976,-1
923,1,STEP,970607961055,970611285026,3323971,-1
924,1,STEP,970611359825,970613959802,2599977,-1
925,1,STEP,970614033501,970617318373,3284872,-1
926,1,STEP,970617391572,970620450945,3059373,-1
927,1,STEP,970620521645,970623225721,2704076,-1
928,1,STEP,970623299320,970626245194,2945874,-1
929,1,STEP,970626320594,970629398467,3077873,-1
930,1,STEP,970629470866,970632410640,2939774,-1
931,1,STEP,970632485140,970635431914,2946774,-1
932,1,STEP,970635506513,970638952783,3446270,-1
933,1,STEP,970639026682,970642517552,3490870,-1
934,1,STEP,970642591851,970645781023,3189172,-1
935,1,STEP,970645852322,970649362992,3510670,-1
936,1,STEP,970649435191,970652809062,3373871,-1
937,1,STEP,970652880261,970655702936,2822675,-1
938,1,STEP,970655774936,970659088206,3313270,-1
939,1,STEP,970659191406,970661804383,2612977,-1
940,1,STEP,970661879282,970664914155,3034873,-1
941,1,STEP,970664986855,970667829430,2842575,-1
942,1,STEP,970667902229,970670735004,2832775,-1
943,1,STEP,970670808704,970673621579,2812875,-1
944,1,STEP,970673692578,970676729052,3036474,-1
945,1,STEP,970676801751,970680072922,3271171,-1
946,1,STEP,970680145722,970683612591,3466869,-1
947,1,STEP,970683687091,970686718564,3031473,-1
948,1,STEP,970686790664,970689088143,2297479,-1
949,1,STEP,970689155843,970692769111,3613268,-1
950,1,STEP,970692843411,970696171981,3328570,-1
951,1,STEP,970696244581,970699207055,2962474,-1
952,1,STEP,970699279054,970702655624,3376570,-1
953,1,STEP,970702727324,970705071703,2344379,-1
954,1,STEP,970705141303,970708356475,3215172,-1
955,1,STEP,970708429474,970711247749,2818275,-1
956,1,STEP,970711319649,970714908617,3588968,-1
957,1,STEP,970714982016,970718068589,3086573,-1
958,1,STEP,970718141389,970721360461,3219072,-1
959,1,STEP,970721454360,970724756931,3302571,-1
960,1,STEP,970724850830,970728000102,3149272,-1
961,1,STEP,970728094601,970731512172,3417571,-1
962,1,STEP,970731606171,970734988141,3381970,-1
963,1,STEP,970735081240,970738021414,2940174,-1
964,1,STEP,970738119814,970741193487,3073673,-1
965,1,STEP,970741285486,970744778755,3493269,-1
966,1,STEP,970744877554,970747962327,3084773,-1
967,1,STEP,970748060926,970750883802,2822876,-1
968,1,STEP,970750978301,970754014474,3036173,-1
969,1,STEP,970754110073,970756640151,2530078,-1
970,1,STEP,970756730250,970759426427,2696177,-1
971,1,STEP,970759518226,970762428800,2910574,-1
972,1,STEP,970762520700,970765519373,2998673,-1
973,1,STEP,970765616573,970768478547,2861974,-1
974,1,STEP,970768572747,970771566720,2993973,-1
975,1,STEP,970771663819,970774715293,3051474,-1
976,1,STEP,970774809192,970777953664,3144472,-1
977,1,STEP,970778045864,970780712040,2666176,-1
978,1,STEP,970780801639,970783934612,3132973,-1
979,1,STEP,970784028811,970787157884,3129073,-1
980,1,STEP,970787250883,970790350956,3100073,-1
981,1,STEP,970790443655,970793281930,2838275,-1
982,1,STEP,970793374029,970796729500,3355471,-1
983,1,STEP,970796822899,970800262269,3439370,-1
984,1,STEP,970800355668,970803163943,2808275,-1
985,1,STEP,970803259142,970806128017,2868875,-1
986,1,STEP,970806218617,970808839294,2620677,-1
987,1,STEP,970808928193,970812208764,3280571,-1
988,1,STEP,970812301163,970815361236,3060073,-1
989,1,STEP,970815459936,970818467309,3007373,-1
990,1,STEP,970818568908,970821246785,2677877,-1
991,1,STEP,970821338184,970824486756,3148572,-1
992,1,STEP,970824561756,970827481830,2920074,-1
993,1,STEP,970827554429,970830474604,2920175,-1
994,1,STEP,970830546703,970833251280,2704577,-1
995,1,STEP,970833322579,970836809548,3486969,-1
996,1,STEP,970836899048,970839918221,3019173,-1
997,1,STEP,970840028520,970843319191,3290671,-1
998,1,STEP,970843413190,970846444564,3031374,-1
999,1,STEP,970846524663,970849620436,3095773,-1
