Gen,Resource,Stamp,TimeStamp_Start,TimeStamp_End,Duration,Indiv_id
0,1,FirstEvaluation,780102626625,780896144185,793517560,-1
0,1,STEP,780896324884,780902123522,5798638,-1
1,1,STEP,780902195221,780906626874,4431653,-1
2,1,STEP,780906698373,780911530922,4832549,-1
3,1,STEP,780911601621,780915767077,4165456,-1
4,1,STEP,780915836876,780919235040,3398164,-1
5,1,STEP,780919302839,780923850691,4547852,-1
6,1,STEP,780923918690,780928251044,4332354,-1
7,1,STEP,780928320243,780932474699,4154456,-1
8,1,STEP,780932541298,780936057161,3515863,-1
9,1,STEP,780936124460,780941013908,4889448,-1
10,1,STEP,780941083007,780944633770,3550763,-1
11,1,STEP,780944700869,780949472218,4771349,-1
12,1,STEP,780949539818,780954451965,4912147,-1
13,1,STEP,780954519565,780958651021,4131456,-1
14,1,STEP,780958718520,780962857776,4139256,-1
15,1,STEP,780962926275,780966141241,3214966,-1
16,1,STEP,780966209540,780970250297,4040757,-1
17,1,STEP,780970317297,780974389953,4072656,-1
18,1,STEP,780974492352,780978165713,3673361,-1
19,1,STEP,780978267312,780981392179,3124867,-1
20,1,STEP,780981493678,780985767432,4273754,-1
21,1,STEP,780985890431,780989505992,3615561,-1
22,1,STEP,780989619291,780993232153,3612862,-1
23,1,STEP,780993326552,780997380709,4054157,-1
24,1,STEP,780997446908,781001831261,4384353,-1
25,1,STEP,781001912960,781006104416,4191456,-1
26,1,STEP,781006214415,781012195251,5980836,-1
27,1,STEP,781012326250,781018429285,6103035,-1
28,1,STEP,781018555783,781023806928,5251145,-1
29,1,STEP,781023932526,781028955473,5022947,-1
30,1,STEP,781029028072,781032702233,3674161,-1
31,1,STEP,781032771532,781036894588,4123056,-1
32,1,STEP,781036971988,781041004345,4032357,-1
33,1,STEP,781041076644,781044354709,3278065,-1
34,1,STEP,781044423608,781047918071,3494463,-1
35,1,STEP,781047989470,781051161537,3172067,-1
36,1,STEP,781051231636,781054661599,3429963,-1
37,1,STEP,781054731199,781057739167,3007968,-1
38,1,STEP,781057805266,781060570637,2765371,-1
39,1,STEP,781060638036,781063649204,3011168,-1
40,1,STEP,781063717603,781067047368,3329765,-1
41,1,STEP,781067118167,781070377832,3259665,-1
42,1,STEP,781070445932,781074194592,3748660,-1
43,1,STEP,781074263991,781077279059,3015068,-1
44,1,STEP,781077345558,781080423325,3077767,-1
45,1,STEP,781080493025,781083892289,3399264,-1
46,1,STEP,781083961188,781086931656,2970468,-1
47,1,STEP,781087000156,781089749826,2749670,-1
48,1,STEP,781089815826,781092759694,2943868,-1
49,1,STEP,781092828694,781095616364,2787670,-1
50,1,STEP,781095684863,781099181926,3497063,-1
51,1,STEP,781099254025,781102939986,3685961,-1
52,1,STEP,781103052985,781107255040,4202055,-1
53,1,STEP,781107339539,781110388007,3048468,-1
54,1,STEP,781110466706,781114326965,3860259,-1
55,1,STEP,781114428364,781118081125,3652761,-1
56,1,STEP,781118160524,781121423789,3263265,-1
57,1,STEP,781121503889,781124246059,2742170,-1
58,1,STEP,781124324359,781126837132,2512773,-1
59,1,STEP,781126915131,781129413504,2498373,-1
60,1,STEP,781129495304,781132212275,2716971,-1
61,1,STEP,781132289874,781135479840,3189966,-1
62,1,STEP,781135562339,781138397809,2835470,-1
63,1,STEP,781138477608,781141547575,3069967,-1
64,1,STEP,781141626774,781145189137,3562363,-1
65,1,STEP,781145272036,781148848398,3576362,-1
66,1,STEP,781148934597,781151306272,2371675,-1
67,1,STEP,781151384571,781154367939,2983368,-1
68,1,STEP,781154446338,781157284108,2837770,-1
69,1,STEP,781157363107,781160030479,2667372,-1
70,1,STEP,781160109878,781162621551,2511673,-1
71,1,STEP,781162700150,781165615719,2915569,-1
72,1,STEP,781165694919,781168907784,3212865,-1
73,1,STEP,781168990783,781172366348,3375565,-1
74,1,STEP,781172448447,781175560314,3111867,-1
75,1,STEP,781175640213,781178709780,3069567,-1
76,1,STEP,781178796879,781181469751,2672872,-1
77,1,STEP,781181552150,781184422019,2869869,-1
78,1,STEP,781184505518,781187374988,2869470,-1
79,1,STEP,781187459387,781190182758,2723371,-1
80,1,STEP,781190263757,781193218626,2954869,-1
81,1,STEP,781193299525,781195965597,2666072,-1
82,1,STEP,781196045796,781199021964,2976168,-1
83,1,STEP,781199101663,781201920633,2818970,-1
84,1,STEP,781202005632,781205045200,3039568,-1
85,1,STEP,781205132199,781207979069,2846870,-1
86,1,STEP,781208060168,781211102736,3042568,-1
87,1,STEP,781211186335,781214176603,2990268,-1
88,1,STEP,781214258302,781217137671,2879369,-1
89,1,STEP,781217220570,781219975841,2755271,-1
90,1,STEP,781220057240,781223251806,3194566,-1
91,1,STEP,781223335205,781226640470,3305265,-1
92,1,STEP,781226723369,781229948235,3224866,-1
93,1,STEP,781230031234,781232564607,2533373,-1
94,1,STEP,781232645006,781235545076,2900070,-1
95,1,STEP,781235627975,781238772041,3144066,-1
96,1,STEP,781238853440,781241640011,2786571,-1
97,1,STEP,781241723210,781244478281,2755071,-1
98,1,STEP,781244564280,781247319650,2755370,-1
99,1,STEP,781247399650,781250471617,3071967,-1
100,1,STEP,781250553916,781253139788,2585872,-1
101,1,STEP,781253220888,781256071357,2850469,-1
102,1,STEP,781256158456,781259134925,2976469,-1
103,1,STEP,781259218624,781261918795,2700171,-1
104,1,STEP,781262001494,781264673966,2672472,-1
105,1,STEP,781264754165,781268027530,3273365,-1
106,1,STEP,781268110729,781271148197,3037468,-1
107,1,STEP,781271230996,781274086066,2855070,-1
108,1,STEP,781274166665,781277471330,3304665,-1
109,1,STEP,781277561329,781280532697,2971368,-1
110,1,STEP,781280613196,781283641564,3028368,-1
111,1,STEP,781283723463,781286751831,3028368,-1
112,1,STEP,781286836030,781289622300,2786270,-1
113,1,STEP,781289704400,781292388171,2683771,-1
114,1,STEP,781292469770,781295541937,3072167,-1
115,1,STEP,781295631837,781298361907,2730070,-1
116,1,STEP,781298442107,781301620973,3178866,-1
117,1,STEP,781301709672,781304824039,3114367,-1
118,1,STEP,781304906638,781308291602,3384964,-1
119,1,STEP,781308374501,781311732765,3358264,-1
120,1,STEP,781311821964,781315177829,3355865,-1
121,1,STEP,781315259528,781318488293,3228765,-1
122,1,STEP,781318571393,781321556161,2984768,-1
123,1,STEP,781321637060,781324582229,2945169,-1
124,1,STEP,781324664028,781327772495,3108467,-1
125,1,STEP,781327862894,781330632064,2769170,-1
126,1,STEP,781330712563,781333612033,2899470,-1
127,1,STEP,781333694332,781337066396,3372064,-1
128,1,STEP,781337178995,781340377161,3198166,-1
129,1,STEP,781340459960,781343380029,2920069,-1
130,1,STEP,781343461628,781346233898,2772270,-1
131,1,STEP,781346315597,781349190167,2874570,-1
132,1,STEP,781349277166,781352042237,2765071,-1
133,1,STEP,781352129436,781354993505,2864069,-1
134,1,STEP,781355074904,781358332570,3257666,-1
135,1,STEP,781358412469,781361448236,3035767,-1
136,1,STEP,781361528736,781364300706,2771970,-1
137,1,STEP,781364379605,781367930968,3551363,-1
138,1,STEP,781368010267,781371020535,3010268,-1
139,1,STEP,781371106734,781374027403,2920669,-1
140,1,STEP,781374107602,781377209169,3101567,-1
141,1,STEP,781377289168,781380480134,3190966,-1
142,1,STEP,781380560633,781384251994,3691361,-1
143,1,STEP,781384334793,781387379161,3044368,-1
144,1,STEP,781387459960,781389846934,2386974,-1
145,1,STEP,781389938333,781393609394,3671061,-1
146,1,STEP,781393692894,781396473264,2780370,-1
147,1,STEP,781396554863,781399337234,2782371,-1
148,1,STEP,781399419033,781402330002,2910969,-1
149,1,STEP,781402410501,781405757365,3346864,-1
150,1,STEP,781405838464,781408883432,3044968,-1
151,1,STEP,781408964431,781412338495,3374064,-1
152,1,STEP,781412426994,781415584361,3157367,-1
153,1,STEP,781415665560,781418328832,2663272,-1
154,1,STEP,781418416131,781421360099,2943968,-1
155,1,STEP,781421440698,781424623965,3183267,-1
156,1,STEP,781424702564,781427523134,2820570,-1
157,1,STEP,781427627033,781430703000,3075967,-1
158,1,STEP,781430773199,781434291462,3518263,-1
159,1,STEP,781434365661,781437444528,3078867,-1
160,1,STEP,781437514527,781440944891,3430364,-1
161,1,STEP,781441014990,781444200456,3185466,-1
162,1,STEP,781444271156,781447352923,3081767,-1
163,1,STEP,781447423222,781450211592,2788370,-1
164,1,STEP,781450281292,781453433358,3152066,-1
165,1,STEP,781453499957,781456489326,2989369,-1
166,1,STEP,781456560625,781459480094,2919469,-1
167,1,STEP,781459550393,781462527461,2977068,-1
168,1,STEP,781462598061,781465758627,3160566,-1
169,1,STEP,781465828126,781468653896,2825770,-1
170,1,STEP,781468724696,781471603465,2878769,-1
171,1,STEP,781471678564,781474662632,2984068,-1
172,1,STEP,781474732832,781477374904,2642072,-1
173,1,STEP,781477443503,781480567170,3123667,-1
174,1,STEP,781480639169,781483800935,3161766,-1
175,1,STEP,781483871934,781486742304,2870370,-1
176,1,STEP,781486815703,781490078468,3262765,-1
177,1,STEP,781490150568,781493233735,3083167,-1
178,1,STEP,781493305534,781495933806,2628272,-1
179,1,STEP,781496005305,781499426269,3420964,-1
180,1,STEP,781499498668,781502207939,2709271,-1
181,1,STEP,781502277639,781504960610,2682971,-1
182,1,STEP,781505030209,781507831080,2800871,-1
183,1,STEP,781507900879,781510806148,2905269,-1
184,1,STEP,781510876447,781514243411,3366964,-1
185,1,STEP,781514314811,781517538776,3223965,-1
186,1,STEP,781517610676,781520137049,2526373,-1
187,1,STEP,781520205548,781523150017,2944469,-1
188,1,STEP,781523220616,781526162685,2942069,-1
189,1,STEP,781526233684,781528759057,2525373,-1
190,1,STEP,781528828356,781531534827,2706471,-1
191,1,STEP,781531603527,781534584795,2981268,-1
192,1,STEP,781534656794,781537210567,2553773,-1
193,1,STEP,781537279866,781540211635,2931769,-1
194,1,STEP,781540282534,781543062205,2779671,-1
195,1,STEP,781543132604,781546001774,2869170,-1
196,1,STEP,781546072673,781549608035,3535362,-1
197,1,STEP,781549679234,781552424305,2745071,-1
198,1,STEP,781552494805,781555506173,3011368,-1
199,1,STEP,781555578172,781558706038,3127866,-1
200,1,STEP,781558777238,781561613608,2836370,-1
201,1,STEP,781561683407,781564619476,2936069,-1
202,1,STEP,781564690875,781567846341,3155466,-1
203,1,STEP,781567951140,781570830310,2879170,-1
204,1,STEP,781570942108,781574269073,3326965,-1
205,1,STEP,781574380672,781577433439,3052767,-1
206,1,STEP,781577544038,781581280098,3736060,-1
207,1,STEP,781581390997,781584472064,3081067,-1
208,1,STEP,781584584263,781587472833,2888570,-1
209,1,STEP,781587583231,781590723698,3140467,-1
210,1,STEP,781590836597,781593383970,2547373,-1
211,1,STEP,781593492868,781596791333,3298465,-1
212,1,STEP,781596907732,781600116598,3208866,-1
213,1,STEP,781600227697,781603812359,3584662,-1
214,1,STEP,781603925058,781607279222,3354164,-1
215,1,STEP,781607393721,781610441388,3047667,-1
216,1,STEP,781610559587,781614038950,3479363,-1
217,1,STEP,781614154749,781617254416,3099667,-1
218,1,STEP,781617367715,781620641880,3274165,-1
219,1,STEP,781620756979,781623662748,2905769,-1
220,1,STEP,781623778046,781627172610,3394564,-1
221,1,STEP,781627288209,781630301677,3013468,-1
222,1,STEP,781630417876,781634082737,3664861,-1
223,1,STEP,781634198736,781637709598,3510862,-1
224,1,STEP,781637826097,781640993963,3167866,-1
225,1,STEP,781641109162,781644291928,3182766,-1
226,1,STEP,781644408627,781647365996,2957369,-1
227,1,STEP,781647481794,781650513962,3032168,-1
228,1,STEP,781650629061,781653369532,2740471,-1
229,1,STEP,781653481630,781656466599,2984969,-1
230,1,STEP,781656585197,781659922162,3336965,-1
231,1,STEP,781660037561,781663136128,3098567,-1
232,1,STEP,781663250727,781665755000,2504273,-1
233,1,STEP,781665877399,781668946666,3069267,-1
234,1,STEP,781669070565,781671813835,2743270,-1
235,1,STEP,781671927634,781675778093,3850459,-1
236,1,STEP,781675896692,781678824661,2927969,-1
237,1,STEP,781678939260,781682461622,3522362,-1
238,1,STEP,781682578121,781685249893,2671772,-1
239,1,STEP,781685363491,781688506858,3143367,-1
240,1,STEP,781688625057,781691919322,3294265,-1
241,1,STEP,781692035820,781695258686,3222866,-1
242,1,STEP,781695378785,781698355253,2976468,-1
243,1,STEP,781698471952,781701609619,3137667,-1
244,1,STEP,781701725517,781705047782,3322265,-1
245,1,STEP,781705165581,781708878841,3713260,-1
246,1,STEP,781708995940,781711377615,2381675,-1
247,1,STEP,781711493513,781714219984,2726471,-1
248,1,STEP,781714335183,781717276652,2941469,-1
249,1,STEP,781717389951,781720472018,3082067,-1
250,1,STEP,781720590617,781724282777,3692160,-1
251,1,STEP,781724401776,781727559443,3157667,-1
252,1,STEP,781727676341,781730961106,3284765,-1
253,1,STEP,781731076105,781733803676,2727571,-1
254,1,STEP,781733928875,781737016742,3087867,-1
255,1,STEP,781737131141,781740260507,3129366,-1
256,1,STEP,781740414406,781743515273,3100867,-1
257,1,STEP,781743631772,781747010336,3378564,-1
258,1,STEP,781747129034,781749764206,2635172,-1
259,1,STEP,781749886705,781753114071,3227366,-1
260,1,STEP,781753231670,781756840031,3608361,-1
261,1,STEP,781756956930,781759922598,2965668,-1
262,1,STEP,781760038797,781762992466,2953669,-1
263,1,STEP,781763108264,781767015123,3906859,-1
264,1,STEP,781767132422,781770197189,3064767,-1
265,1,STEP,781770312288,781772816361,2504073,-1
266,1,STEP,781772929060,781776141726,3212666,-1
267,1,STEP,781776257825,781779714888,3457063,-1
268,1,STEP,781779823287,781782336660,2513373,-1
269,1,STEP,781782447159,781785671724,3224565,-1
270,1,STEP,781785757224,781789354785,3597561,-1
271,1,STEP,781789446384,781792814649,3368265,-1
272,1,STEP,781792906448,781796135713,3229265,-1
273,1,STEP,781796223512,781798688686,2465174,-1
274,1,STEP,781798773685,781801429857,2656172,-1
275,1,STEP,781801513856,781804817221,3303365,-1
276,1,STEP,781804907020,781808161285,3254265,-1
277,1,STEP,781808247984,781811161653,2913669,-1
278,1,STEP,781811247252,781814310320,3063068,-1
279,1,STEP,781814393119,781817445287,3052168,-1
280,1,STEP,781817530086,781820722452,3192366,-1
281,1,STEP,781820809051,781823434223,2625172,-1
282,1,STEP,781823518122,781826415291,2897169,-1
283,1,STEP,781826501090,781829388360,2887270,-1
284,1,STEP,781829472259,781832615725,3143466,-1
285,1,STEP,781832701824,781835886090,3184266,-1
286,1,STEP,781835970690,781839191355,3220665,-1
287,1,STEP,781839275554,781842221523,2945969,-1
288,1,STEP,781842304622,781845363190,3058568,-1
289,1,STEP,781845447389,781847903863,2456474,-1
290,1,STEP,781847986762,781850820832,2834070,-1
291,1,STEP,781850910031,781853659601,2749570,-1
292,1,STEP,781853743900,781857014866,3270966,-1
293,1,STEP,781857101665,781860150032,3048367,-1
294,1,STEP,781860235931,781863351198,3115267,-1
295,1,STEP,781863436297,781866893961,3457664,-1
296,1,STEP,781866980360,781869733530,2753170,-1
297,1,STEP,781869816430,781872774598,2958168,-1
298,1,STEP,781872858497,781875987564,3129067,-1
299,1,STEP,781876071363,781878889333,2817970,-1
300,1,STEP,781878973432,781882021600,3048168,-1
301,1,STEP,781882104399,781884585472,2481073,-1
302,1,STEP,781884666672,781887581241,2914569,-1
303,1,STEP,781887664840,781890636808,2971968,-1
304,1,STEP,781890719607,781893785975,3066368,-1
305,1,STEP,781893879074,781896946941,3067867,-1
306,1,STEP,781897031040,781900343205,3312165,-1
307,1,STEP,781900428004,781903176275,2748271,-1
308,1,STEP,781903259174,781906236242,2977068,-1
309,1,STEP,781906318641,781908796215,2477574,-1
310,1,STEP,781908877314,781912328077,3450763,-1
311,1,STEP,781912412876,781915611242,3198366,-1
312,1,STEP,781915694942,781918812208,3117266,-1
313,1,STEP,781918896008,781921967675,3071667,-1
314,1,STEP,781922053174,781924911344,2858170,-1
315,1,STEP,781924995343,781928030210,3034867,-1
316,1,STEP,781928115809,781930985979,2870170,-1
317,1,STEP,781931070978,781933860548,2789570,-1
318,1,STEP,781933952747,781937102114,3149367,-1
319,1,STEP,781937186313,781940455078,3268765,-1
320,1,STEP,781940540077,781943611645,3071568,-1
321,1,STEP,781943695544,781947066808,3371264,-1
322,1,STEP,781947151707,781950233974,3082267,-1
323,1,STEP,781950318473,781953699937,3381464,-1
324,1,STEP,781953785236,781956558107,2772871,-1
325,1,STEP,781956641906,781959870872,3228966,-1
326,1,STEP,781959955071,781963374734,3419663,-1
327,1,STEP,781963461334,781966379703,2918369,-1
328,1,STEP,781966464902,781969064574,2599672,-1
329,1,STEP,781969148573,781972147041,2998468,-1
330,1,STEP,781972231340,781975331107,3099767,-1
331,1,STEP,781975420306,781978451674,3031368,-1
332,1,STEP,781978535373,781980972247,2436874,-1
333,1,STEP,781981052846,781984200113,3147267,-1
334,1,STEP,781984281212,781987274580,2993368,-1
335,1,STEP,781987358179,781990051751,2693572,-1
336,1,STEP,781990135950,781993123618,2987668,-1
337,1,STEP,781993206817,781996100086,2893269,-1
338,1,STEP,781996183486,781999258353,3074867,-1
339,1,STEP,781999341452,782002170522,2829070,-1
340,1,STEP,782002252921,782005514286,3261365,-1
341,1,STEP,782005600085,782008809451,3209366,-1
342,1,STEP,782008906450,782012122816,3216366,-1
343,1,STEP,782012208815,782015443581,3234766,-1
344,1,STEP,782015528180,782018711746,3183566,-1
345,1,STEP,782018795945,782021612015,2816070,-1
346,1,STEP,782021693114,782024626983,2933869,-1
347,1,STEP,782024714882,782027745850,3030968,-1
348,1,STEP,782027830349,782031193413,3363064,-1
349,1,STEP,782031281312,782034522878,3241566,-1
350,1,STEP,782034609777,782037605645,2995868,-1
351,1,STEP,782037688844,782040678912,2990068,-1
352,1,STEP,782040778811,782044014077,3235266,-1
353,1,STEP,782044099276,782047012245,2912969,-1
354,1,STEP,782047095544,782050021013,2925469,-1
355,1,STEP,782050112012,782053647974,3535962,-1
356,1,STEP,782053733773,782056761841,3028068,-1
357,1,STEP,782056845840,782059837508,2991668,-1
358,1,STEP,782059924908,782062741278,2816370,-1
359,1,STEP,782062824677,782066677336,3852659,-1
360,1,STEP,782066813334,782070856191,4042857,-1
361,1,STEP,782070942190,782074087157,3144967,-1
362,1,STEP,782074170456,782076853728,2683272,-1
363,1,STEP,782076935727,782079496699,2560972,-1
364,1,STEP,782079583498,782082567767,2984269,-1
365,1,STEP,782082651266,782085801032,3149766,-1
366,1,STEP,782085901931,782089267195,3365264,-1
367,1,STEP,782089403694,782092488561,3084867,-1
368,1,STEP,782092563860,782095356531,2792671,-1
369,1,STEP,782095431030,782098373199,2942169,-1
370,1,STEP,782098446498,782100850672,2404174,-1
371,1,STEP,782100921972,782104089738,3167766,-1
372,1,STEP,782104163937,782107363803,3199866,-1
373,1,STEP,782107437502,782110270872,2833370,-1
374,1,STEP,782110344571,782113225241,2880670,-1
375,1,STEP,782113297940,782116135910,2837970,-1
376,1,STEP,782116209409,782119090178,2880769,-1
377,1,STEP,782119176177,782122633041,3456864,-1
378,1,STEP,782122710440,782125768407,3057967,-1
379,1,STEP,782125843906,782128743976,2900070,-1
380,1,STEP,782128817975,782131902442,3084467,-1
381,1,STEP,782131978441,782134540714,2562273,-1
382,1,STEP,782134613513,782137844379,3230866,-1
383,1,STEP,782137950278,782140835247,2884969,-1
384,1,STEP,782140908346,782144006413,3098067,-1
385,1,STEP,782144081612,782147023581,2941969,-1
386,1,STEP,782147098180,782150276347,3178167,-1
387,1,STEP,782150352946,782153331714,2978768,-1
388,1,STEP,782153405813,782156513880,3108067,-1
389,1,STEP,782156588179,782159264551,2676372,-1
390,1,STEP,782159337850,782162402718,3064868,-1
391,1,STEP,782162477217,782165450185,2972968,-1
392,1,STEP,782165524084,782168704751,3180667,-1
393,1,STEP,782168778750,782171860617,3081867,-1
394,1,STEP,782171932316,782174973484,3041168,-1
395,1,STEP,782175046183,782178462147,3415964,-1
396,1,STEP,782178538246,782181563714,3025468,-1
397,1,STEP,782181636813,782184378084,2741271,-1
398,1,STEP,782184450383,782187455651,3005268,-1
399,1,STEP,782187529150,782191017513,3488363,-1
400,1,STEP,782191093012,782194060181,2967169,-1
401,1,STEP,782194134380,782196864051,2729671,-1
402,1,STEP,782196936250,782199301125,2364875,-1
403,1,STEP,782199371524,782202434492,3062968,-1
404,1,STEP,782202507191,782205065164,2557973,-1
405,1,STEP,782205134863,782208683425,3548562,-1
406,1,STEP,782208822724,782212229488,3406764,-1
407,1,STEP,782212306687,782215542652,3235965,-1
408,1,STEP,782215618052,782219048315,3430263,-1
409,1,STEP,782219183814,782223052173,3868359,-1
410,1,STEP,782223127072,782225995441,2868369,-1
411,1,STEP,782226068740,782229283906,3215166,-1
412,1,STEP,782229356806,782232064277,2707471,-1
413,1,STEP,782232136776,782235604739,3467963,-1
414,1,STEP,782235680538,782238591707,2911169,-1
415,1,STEP,782238675106,782241051181,2376075,-1
416,1,STEP,782241135080,782244250247,3115167,-1
417,1,STEP,782244332546,782246989518,2656972,-1
418,1,STEP,782247070117,782250076285,3006168,-1
419,1,STEP,782250157984,782253168552,3010568,-1
420,1,STEP,782253247551,782255983922,2736371,-1
421,1,STEP,782256064721,782258883191,2818470,-1
422,1,STEP,782258964391,782262293955,3329564,-1
423,1,STEP,782262377354,782265459722,3082368,-1
424,1,STEP,782265538521,782268387090,2848569,-1
425,1,STEP,782268470290,782271458258,2987968,-1
426,1,STEP,782271541957,782274834422,3292465,-1
427,1,STEP,782274923721,782277472894,2549173,-1
428,1,STEP,782277551493,782281089455,3537962,-1
429,1,STEP,782281176954,782284270621,3093667,-1
430,1,STEP,782284354821,782287166691,2811870,-1
431,1,STEP,782287249290,782290305557,3056267,-1
432,1,STEP,782290389956,782293105327,2715371,-1
433,1,STEP,782293187727,782296682389,3494662,-1
434,1,STEP,782296764389,782299463360,2698971,-1
435,1,STEP,782299544659,782302858624,3313965,-1
436,1,STEP,782302942423,782305756193,2813770,-1
437,1,STEP,782305841992,782308955559,3113567,-1
438,1,STEP,782309037758,782312486921,3449163,-1
439,1,STEP,782312571620,782315742287,3170667,-1
440,1,STEP,782315822186,782318764655,2942469,-1
441,1,STEP,782318848454,782321448426,2599972,-1
442,1,STEP,782321531925,782324758691,3226766,-1
443,1,STEP,782324842790,782328570450,3727660,-1
444,1,STEP,782328654749,782331919515,3264766,-1
445,1,STEP,782332003414,782334542987,2539573,-1
446,1,STEP,782334625786,782337995050,3369264,-1
447,1,STEP,782338079549,782340834720,2755171,-1
448,1,STEP,782340917119,782343755889,2838770,-1
449,1,STEP,782343841188,782346669858,2828670,-1
450,1,STEP,782346754457,782349509928,2755471,-1
451,1,STEP,782349593827,782352593395,2999568,-1
452,1,STEP,782352683894,782355833060,3149166,-1
453,1,STEP,782355919259,782358984527,3065268,-1
454,1,STEP,782359068726,782362128993,3060267,-1
455,1,STEP,782362211892,782365361659,3149767,-1
456,1,STEP,782365442058,782368463126,3021068,-1
457,1,STEP,782368545825,782371535393,2989568,-1
458,1,STEP,782371619792,782374617261,2997469,-1
459,1,STEP,782374699160,782377973525,3274365,-1
460,1,STEP,782378056724,782381165391,3108667,-1
461,1,STEP,782381249390,782384346257,3096867,-1
462,1,STEP,782384431056,782387410524,2979468,-1
463,1,STEP,782387494624,782390723189,3228565,-1
464,1,STEP,782390807788,782394078654,3270866,-1
465,1,STEP,782394161953,782397696115,3534162,-1
466,1,STEP,782397787114,782401087079,3299965,-1
467,1,STEP,782401169378,782404447743,3278365,-1
468,1,STEP,782404532142,782407930606,3398464,-1
469,1,STEP,782408015105,782411427769,3412664,-1
470,1,STEP,782411511668,782415083230,3571562,-1
471,1,STEP,782415168529,782418111698,2943169,-1
472,1,STEP,782418201097,782421816959,3615862,-1
473,1,STEP,782421910658,782425258722,3348064,-1
474,1,STEP,782425343521,782429279379,3935858,-1
475,1,STEP,782429366678,782432216848,2850170,-1
476,1,STEP,782432301347,782435330415,3029068,-1
477,1,STEP,782435419114,782439358172,3939058,-1
478,1,STEP,782439477971,782443263830,3785859,-1
479,1,STEP,782443349430,782446379497,3030067,-1
480,1,STEP,782446467396,782449450365,2982969,-1
481,1,STEP,782449537964,782453203525,3665561,-1
482,1,STEP,782453312224,782455943496,2631272,-1
483,1,STEP,782456057794,782459068062,3010268,-1
484,1,STEP,782459184861,782462127830,2942969,-1
485,1,STEP,782462243129,782465749991,3506862,-1
486,1,STEP,782465878490,782468660260,2781770,-1
487,1,STEP,782468773359,782471675328,2901969,-1
488,1,STEP,782471793327,782475257590,3464263,-1
489,1,STEP,782475379289,782478696154,3316865,-1
490,1,STEP,782478812652,782481734021,2921369,-1
491,1,STEP,782481850220,782484865388,3015168,-1
492,1,STEP,782484979987,782488440550,3460563,-1
493,1,STEP,782488554249,782491226020,2671771,-1
494,1,STEP,782491340119,782494168589,2828470,-1
495,1,STEP,782494282788,782497026159,2743371,-1
496,1,STEP,782497138957,782500071826,2932869,-1
497,1,STEP,782500180725,782503215793,3035068,-1
498,1,STEP,782503323792,782507203050,3879258,-1
499,1,STEP,782507318349,782510568015,3249666,-1
500,1,STEP,782510680613,782513989178,3308565,-1
501,1,STEP,782514103877,782516910047,2806170,-1
502,1,STEP,782517024046,782520092113,3068067,-1
503,1,STEP,782520206712,782523412478,3205766,-1
504,1,STEP,782523540177,782526561744,3021567,-1
505,1,STEP,782526675443,782529672711,2997268,-1
506,1,STEP,782529783710,782532598080,2814370,-1
507,1,STEP,782532712579,782535826346,3113767,-1
508,1,STEP,782535941245,782539096211,3154966,-1
509,1,STEP,782539232710,782542189678,2956968,-1
510,1,STEP,782542302077,782545208546,2906469,-1
511,1,STEP,782545314745,782548392312,3077567,-1
512,1,STEP,782548544011,782551541279,2997268,-1
513,1,STEP,782551652178,782554393048,2740870,-1
514,1,STEP,782554501547,782557516515,3014968,-1
515,1,STEP,782557619314,782560443884,2824570,-1
516,1,STEP,782560551583,782563789349,3237766,-1
517,1,STEP,782563899547,782566943515,3043968,-1
518,1,STEP,782567054114,782570453378,3399264,-1
519,1,STEP,782570565976,782573702543,3136567,-1
520,1,STEP,782573813242,782577227506,3414264,-1
521,1,STEP,782577332604,782580665069,3332465,-1
522,1,STEP,782580777968,782584037233,3259265,-1
523,1,STEP,782584144632,782587487496,3342864,-1
524,1,STEP,782587595595,782590851761,3256166,-1
525,1,STEP,782590963159,782594488822,3525663,-1
526,1,STEP,782594599521,782597670588,3071067,-1
527,1,STEP,782597778787,782600769755,2990968,-1
528,1,STEP,782600883154,782603728924,2845770,-1
529,1,STEP,782603836623,782607211387,3374764,-1
530,1,STEP,782607327085,782610529551,3202466,-1
531,1,STEP,782610638350,782614075414,3437064,-1
532,1,STEP,782614189812,782616974583,2784771,-1
533,1,STEP,782617082982,782620404246,3321264,-1
534,1,STEP,782620520645,782623336615,2815970,-1
535,1,STEP,782623449014,782626660280,3211266,-1
536,1,STEP,782626795578,782629676648,2881070,-1
537,1,STEP,782629787847,782632502418,2714571,-1
538,1,STEP,782632612917,782636482075,3869158,-1
539,1,STEP,782636596074,782639204546,2608472,-1
540,1,STEP,782639316245,782642230814,2914569,-1
541,1,STEP,782642342413,782645785476,3443063,-1
542,1,STEP,782645903675,782648190851,2287176,-1
543,1,STEP,782648293750,782651418916,3125166,-1
544,1,STEP,782651531715,782654509384,2977669,-1
545,1,STEP,782654617182,782658091046,3473864,-1
546,1,STEP,782658207744,782660980915,2773171,-1
547,1,STEP,782661093214,782664511677,3418463,-1
548,1,STEP,782664628776,782668128239,3499463,-1
549,1,STEP,782668243938,782671423904,3179966,-1
550,1,STEP,782671534703,782674763868,3229165,-1
551,1,STEP,782674878767,782677943634,3064867,-1
552,1,STEP,782678057633,782680952402,2894769,-1
553,1,STEP,782681064401,782684295167,3230766,-1
554,1,STEP,782684415366,782687837629,3422263,-1
555,1,STEP,782687948128,782691233793,3285665,-1
556,1,STEP,782691350292,782694229061,2878769,-1
557,1,STEP,782694344960,782697165630,2820670,-1
558,1,STEP,782697281029,782700690392,3409363,-1
559,1,STEP,782700806191,782703698460,2892269,-1
560,1,STEP,782703814359,782706506431,2692072,-1
561,1,STEP,782706614629,782709222402,2607773,-1
562,1,STEP,782709295601,782711949973,2654372,-1
563,1,STEP,782712022672,782715261537,3238865,-1
564,1,STEP,782715336337,782718833699,3497362,-1
565,1,STEP,782718907799,782721947166,3039367,-1
566,1,STEP,782722020066,782724930035,2909969,-1
567,1,STEP,782725001134,782728207500,3206366,-1
568,1,STEP,782728281499,782731091069,2809570,-1
569,1,STEP,782731164468,782734227336,3062868,-1
570,1,STEP,782734300535,782737641399,3340864,-1
571,1,STEP,782737713399,782741060263,3346864,-1
572,1,STEP,782741133162,782744008032,2874870,-1
573,1,STEP,782744078931,782747082299,3003368,-1
574,1,STEP,782747156398,782750258265,3101867,-1
575,1,STEP,782750330464,782753458531,3128067,-1
576,1,STEP,782753530130,782756371900,2841770,-1
577,1,STEP,782756443599,782759472167,3028568,-1
578,1,STEP,782759543766,782762668533,3124767,-1
579,1,STEP,782762742232,782765818500,3076268,-1
580,1,STEP,782765899399,782768773968,2874569,-1
581,1,STEP,782768843468,782771524639,2681171,-1
582,1,STEP,782771596138,782774908403,3312265,-1
583,1,STEP,782774982102,782777630374,2648272,-1
584,1,STEP,782777700773,782780640342,2939569,-1
585,1,STEP,782780710241,782783689710,2979469,-1
586,1,STEP,782783761409,782787046474,3285065,-1
587,1,STEP,782787120273,782790334939,3214666,-1
588,1,STEP,782790408138,782793921501,3513363,-1
589,1,STEP,782794043100,782797629261,3586161,-1
590,1,STEP,782797703961,782800952826,3248865,-1
591,1,STEP,782801026925,782804251091,3224166,-1
592,1,STEP,782804325090,782808006351,3681261,-1
593,1,STEP,782808080850,782811069618,2988768,-1
594,1,STEP,782811144118,782813754690,2610572,-1
595,1,STEP,782813826289,782816737358,2911069,-1
596,1,STEP,782816810657,782819508829,2698172,-1
597,1,STEP,782819581628,782822445297,2863669,-1
598,1,STEP,782822529497,782825306267,2776770,-1
599,1,STEP,782825375766,782828773330,3397564,-1
600,1,STEP,782828847429,782832041595,3194166,-1
601,1,STEP,782832111795,782835381060,3269265,-1
602,1,STEP,782835457159,782838456527,2999368,-1
603,1,STEP,782838527726,782841639793,3112067,-1
604,1,STEP,782841711593,782844526263,2814670,-1
605,1,STEP,782844598962,782848088725,3489763,-1
606,1,STEP,782848162224,782851057393,2895169,-1
607,1,STEP,782851132992,782854212560,3079568,-1
608,1,STEP,782854286559,782857284927,2998368,-1
609,1,STEP,782857357126,782860392494,3035368,-1
610,1,STEP,782860466493,782863553560,3087067,-1
611,1,STEP,782863627459,782866254732,2627273,-1
612,1,STEP,782866328031,782869164501,2836470,-1
613,1,STEP,782869235900,782871913371,2677471,-1
614,1,STEP,782871987471,782875299435,3311964,-1
615,1,STEP,782875372835,782878337403,2964568,-1
616,1,STEP,782878410802,782881202373,2791571,-1
617,1,STEP,782881275272,782883833245,2557973,-1
618,1,STEP,782883907244,782886997711,3090467,-1
619,1,STEP,782887071110,782890209377,3138267,-1
620,1,STEP,782890282976,782893358143,3075167,-1
621,1,STEP,782893430242,782896209113,2778871,-1
622,1,STEP,782896282512,782899114982,2832470,-1
623,1,STEP,782899189581,782902280848,3091267,-1
624,1,STEP,782902356548,782905663012,3306464,-1
625,1,STEP,782905737812,782908996177,3258365,-1
626,1,STEP,782909070776,782912025645,2954869,-1
627,1,STEP,782912098844,782915343109,3244265,-1
628,1,STEP,782915417209,782918658674,3241465,-1
629,1,STEP,782918732373,782921693442,2961069,-1
630,1,STEP,782921765441,782925331203,3565762,-1
631,1,STEP,782925406802,782928291872,2885070,-1
632,1,STEP,782928366071,782931376339,3010268,-1
633,1,STEP,782931448538,782934487406,3038868,-1
634,1,STEP,782934560905,782937546073,2985168,-1
635,1,STEP,782937616773,782940513642,2896869,-1
636,1,STEP,782940586341,782944325301,3738960,-1
637,1,STEP,782944465600,782949837243,5371643,-1
638,1,STEP,782949979741,782954765690,4785949,-1
639,1,STEP,782954896489,782959039745,4143256,-1
640,1,STEP,782959168343,782963595796,4427453,-1
641,1,STEP,782963722995,782968379145,4656150,-1
642,1,STEP,782968507844,782972967297,4459453,-1
643,1,STEP,782973095995,782977546148,4450153,-1
644,1,STEP,782977671747,782982638894,4967147,-1
645,1,STEP,782982764092,782987447543,4683451,-1
646,1,STEP,782987725740,782992441389,4715649,-1
647,1,STEP,782992796786,782998279527,5482741,-1
648,1,STEP,782998622424,783002971477,4349053,-1
649,1,STEP,783003292774,783008415420,5122646,-1
650,1,STEP,783008555218,783013179969,4624751,-1
651,1,STEP,783013334367,783017724021,4389654,-1
652,1,STEP,783017853219,783022725167,4871948,-1
653,1,STEP,783023080964,783027123321,4042357,-1
654,1,STEP,783027249219,783032509263,5260044,-1
655,1,STEP,783032636662,783037553910,4917248,-1
656,1,STEP,783037678108,783042286259,4608151,-1
657,1,STEP,783042411458,783046731812,4320354,-1
658,1,STEP,783046857111,783050646570,3789459,-1
659,1,STEP,783050769169,783054277132,3507963,-1
660,1,STEP,783054388031,783057884693,3496662,-1
661,1,STEP,783058003092,783061402256,3399164,-1
662,1,STEP,783061518955,783064687621,3168666,-1
663,1,STEP,783064804620,783069104574,4299954,-1
664,1,STEP,783069236573,783073841824,4605251,-1
665,1,STEP,783073985322,783079088868,5103546,-1
666,1,STEP,783079217166,783083452121,4234955,-1
667,1,STEP,783083570320,783088485368,4915048,-1
668,1,STEP,783088627566,783092646824,4019258,-1
669,1,STEP,783092766622,783095935889,3169267,-1
670,1,STEP,783096012688,783099890947,3878259,-1
671,1,STEP,783100008845,783105127691,5118846,-1
672,1,STEP,783105270989,783110335036,5064047,-1
673,1,STEP,783110467234,783114869587,4402353,-1
674,1,STEP,783115002086,783119500938,4498852,-1
675,1,STEP,783119628637,783124555084,4926447,-1
676,1,STEP,783124684883,783128919438,4234555,-1
677,1,STEP,783129049536,783133855685,4806149,-1
678,1,STEP,783133996284,783137780144,3783860,-1
679,1,STEP,783137921742,783142804090,4882348,-1
680,1,STEP,783142942089,783148247032,5304943,-1
681,1,STEP,783148390931,783151915593,3524662,-1
682,1,STEP,783152031592,783155657053,3625461,-1
683,1,STEP,783155734453,783159095917,3361464,-1
684,1,STEP,783159213816,783162349082,3135266,-1
685,1,STEP,783162465081,783165963344,3498263,-1
686,1,STEP,783166077343,783169413607,3336264,-1
687,1,STEP,783169527406,783173145167,3617761,-1
688,1,STEP,783173263066,783176316634,3053568,-1
689,1,STEP,783176431633,783179754097,3322464,-1
690,1,STEP,783179871796,783182921563,3049767,-1
691,1,STEP,783183034862,783186231828,3196966,-1
692,1,STEP,783186346127,783190379384,4033257,-1
693,1,STEP,783190494383,783193163655,2669272,-1
694,1,STEP,783193275653,783196212722,2937069,-1
695,1,STEP,783196324921,783199380988,3056067,-1
696,1,STEP,783199492987,783202546055,3053068,-1
697,1,STEP,783202664254,783205582322,2918068,-1
698,1,STEP,783205667622,783209742878,4075256,-1
699,1,STEP,783209844477,783213667636,3823159,-1
700,1,STEP,783213752836,783217106200,3353364,-1
701,1,STEP,783217191099,783220402965,3211866,-1
702,1,STEP,783220486264,783224347423,3861159,-1
703,1,STEP,783224481721,783228471179,3989458,-1
704,1,STEP,783228601878,783233119930,4518052,-1
705,1,STEP,783233245228,783237150187,3904959,-1
706,1,STEP,783237287585,783240189354,2901769,-1
707,1,STEP,783240275353,783243491819,3216466,-1
708,1,STEP,783243580018,783246825484,3245466,-1
709,1,STEP,783246910883,783250202948,3292065,-1
710,1,STEP,783250288047,783255224294,4936247,-1
711,1,STEP,783255343493,783258179763,2836270,-1
712,1,STEP,783258257662,783261408829,3151167,-1
713,1,STEP,783261484328,783265326487,3842159,-1
714,1,STEP,783265399186,783268498153,3098967,-1
715,1,STEP,783268572153,783271766619,3194466,-1
716,1,STEP,783271842418,783274991584,3149166,-1
717,1,STEP,783275067383,783277834054,2766671,-1
718,1,STEP,783277928753,783280603525,2674772,-1
719,1,STEP,783280677024,783283774891,3097867,-1
720,1,STEP,783283848790,783287192754,3343964,-1
721,1,STEP,783287266754,783290182623,2915869,-1
722,1,STEP,783290256122,783293799984,3543862,-1
723,1,STEP,783293888183,783296867352,2979169,-1
724,1,STEP,783296940551,783300379214,3438663,-1
725,1,STEP,783300453813,783303780678,3326865,-1
726,1,STEP,783303855577,783306888145,3032568,-1
727,1,STEP,783306961344,783310102111,3140767,-1
728,1,STEP,783310175610,783313181778,3006168,-1
729,1,STEP,783313251777,783316696141,3444364,-1
730,1,STEP,783316769440,783320438601,3669161,-1
731,1,STEP,783320511300,783323627967,3116667,-1
732,1,STEP,783323700466,783326411337,2710871,-1
733,1,STEP,783326483037,783329315006,2831969,-1
734,1,STEP,783329388206,783331956178,2567972,-1
735,1,STEP,783332025378,783334698349,2672971,-1
736,1,STEP,783334771948,783337777116,3005168,-1
737,1,STEP,783337849316,783340558387,2709071,-1
738,1,STEP,783340631986,783343482156,2850170,-1
739,1,STEP,783343555155,783346681422,3126267,-1
740,1,STEP,783346756521,783349510292,2753771,-1
741,1,STEP,783349583291,783352367261,2783970,-1
742,1,STEP,783352440561,783355571727,3131166,-1
743,1,STEP,783355645626,783359316987,3671361,-1
744,1,STEP,783359392987,783362402455,3009468,-1
745,1,STEP,783362476554,783365818318,3341764,-1
746,1,STEP,783365900317,783369087583,3187266,-1
747,1,STEP,783369163183,783371743155,2579972,-1
748,1,STEP,783371816754,783374976421,3159667,-1
749,1,STEP,783375050420,783377480494,2430074,-1
750,1,STEP,783377553293,783380731060,3177767,-1
751,1,STEP,783380805359,783383986125,3180766,-1
752,1,STEP,783384059624,783387044892,2985268,-1
753,1,STEP,783387118992,783389662865,2543873,-1
754,1,STEP,783389735464,783393022429,3286965,-1
755,1,STEP,783393096728,783395742500,2645772,-1
756,1,STEP,783395814799,783398840667,3025868,-1
757,1,STEP,783398913566,783401679737,2766171,-1
758,1,STEP,783401751136,783404987502,3236366,-1
759,1,STEP,783405061001,783408283367,3222366,-1
760,1,STEP,783408355466,783410964738,2609272,-1
761,1,STEP,783411036637,783414368302,3331665,-1
762,1,STEP,783414443801,783417409969,2966168,-1
763,1,STEP,783417483369,783420305039,2821670,-1
764,1,STEP,783420378538,783423141109,2762571,-1
765,1,STEP,783423214408,783426017478,2803070,-1
766,1,STEP,783426091377,783429586540,3495163,-1
767,1,STEP,783429662039,783433060503,3398464,-1
768,1,STEP,783433143902,783435970972,2827070,-1
769,1,STEP,783436045671,783438417546,2371875,-1
770,1,STEP,783438490145,783441769810,3279665,-1
771,1,STEP,783441842610,783444857378,3014768,-1
772,1,STEP,783444930077,783447825646,2895569,-1
773,1,STEP,783447899145,783451431808,3532663,-1
774,1,STEP,783451507107,783454370876,2863769,-1
775,1,STEP,783454443276,783457473843,3030567,-1
776,1,STEP,783457545843,783460871807,3325964,-1
777,1,STEP,783460945606,783463816076,2870470,-1
778,1,STEP,783463889675,783466911443,3021768,-1
779,1,STEP,783466985142,783470275707,3290565,-1
780,1,STEP,783470351906,783472956179,2604273,-1
781,1,STEP,783473029278,783475414353,2385075,-1
782,1,STEP,783475486852,783478601419,3114567,-1
783,1,STEP,783478675218,783481562287,2887069,-1
784,1,STEP,783481634386,783484368657,2734271,-1
785,1,STEP,783484437057,783487544324,3107267,-1
786,1,STEP,783487618123,783490661690,3043567,-1
787,1,STEP,783490734190,783493308062,2573872,-1
788,1,STEP,783493376462,783496655327,3278865,-1
789,1,STEP,783496726926,783499852393,3125467,-1
790,1,STEP,783499926292,783503332956,3406664,-1
791,1,STEP,783503408155,783506515322,3107167,-1
792,1,STEP,783506588021,783509805487,3217466,-1
793,1,STEP,783509896786,783513036552,3139766,-1
794,1,STEP,783513110252,783516504916,3394664,-1
795,1,STEP,783516578915,783519703682,3124767,-1
796,1,STEP,783519779081,783523169745,3390664,-1
797,1,STEP,783523244544,783525902516,2657972,-1
798,1,STEP,783525975015,783529204180,3229165,-1
799,1,STEP,783529278380,783532201349,2922969,-1
800,1,STEP,783532273548,783535117918,2844370,-1
801,1,STEP,783535189217,783538566581,3377364,-1
802,1,STEP,783538641180,783541248552,2607372,-1
803,1,STEP,783541318652,783544991913,3673261,-1
804,1,STEP,783545066412,783548628774,3562362,-1
805,1,STEP,783548701973,783551393544,2691571,-1
806,1,STEP,783551464244,783554726509,3262265,-1
807,1,STEP,783554823708,783557914175,3090467,-1
808,1,STEP,783557986374,783560703445,2717071,-1
809,1,STEP,783560773745,783563660514,2886769,-1
810,1,STEP,783563732813,783566333086,2600273,-1
811,1,STEP,783566403385,783569578851,3175466,-1
812,1,STEP,783569650350,783572929915,3279565,-1
813,1,STEP,783573001115,783576031782,3030667,-1
814,1,STEP,783576105182,783578947951,2842769,-1
815,1,STEP,783579019751,783582722111,3702360,-1
816,1,STEP,783582792311,783586454272,3661961,-1
817,1,STEP,783586528071,783589765036,3236965,-1
818,1,STEP,783589836036,783592914903,3078867,-1
819,1,STEP,783592985902,783596010270,3024368,-1
820,1,STEP,783596081369,783598818940,2737571,-1
821,1,STEP,783598902639,783601957307,3054668,-1
822,1,STEP,783602029606,783604765477,2735871,-1
823,1,STEP,783604833576,783607988343,3154767,-1
824,1,STEP,783608058942,783610507616,2448674,-1
825,1,STEP,783610577315,783613273986,2696671,-1
826,1,STEP,783613343086,783616537252,3194166,-1
827,1,STEP,783616608151,783619055125,2446974,-1
828,1,STEP,783619124724,783621875795,2751071,-1
829,1,STEP,783621948094,783624825663,2877569,-1
830,1,STEP,783624894563,783627582234,2687671,-1
831,1,STEP,783627652133,783630399904,2747771,-1
832,1,STEP,783630465503,783633498771,3033268,-1
833,1,STEP,783633568370,783636223642,2655272,-1
834,1,STEP,783636295241,783639508307,3213066,-1
835,1,STEP,783639582206,783642475476,2893270,-1
836,1,STEP,783642548275,783646017038,3468763,-1
837,1,STEP,783646090537,783649046006,2955469,-1
838,1,STEP,783649116905,783651867176,2750271,-1
839,1,STEP,783651940275,783654598247,2657972,-1
840,1,STEP,783654672046,783657568515,2896469,-1
841,1,STEP,783657641014,783660596983,2955969,-1
842,1,STEP,783660670282,783663460253,2789971,-1
843,1,STEP,783663531852,783666869116,3337264,-1
844,1,STEP,783666943215,783670124882,3181667,-1
845,1,STEP,783670194581,783673419247,3224666,-1
846,1,STEP,783673493046,783676853810,3360764,-1
847,1,STEP,783676928509,783680216174,3287665,-1
848,1,STEP,783680288474,783683529239,3240765,-1
849,1,STEP,783683602038,783687123201,3521163,-1
850,1,STEP,783687197700,783689923471,2725771,-1
851,1,STEP,783689996170,783693227536,3231366,-1
852,1,STEP,783693300335,783696905697,3605362,-1
853,1,STEP,783696980496,783700191762,3211266,-1
854,1,STEP,783700273661,783703098031,2824370,-1
855,1,STEP,783703172530,783706049200,2876670,-1
856,1,STEP,783706123599,783708946569,2822970,-1
857,1,STEP,783709018668,783712103035,3084367,-1
858,1,STEP,783712177334,783715599798,3422464,-1
859,1,STEP,783715676697,783718983062,3306365,-1
860,1,STEP,783719057061,783722271227,3214166,-1
861,1,STEP,783722345126,783725486993,3141867,-1
862,1,STEP,783725561092,783728948956,3387864,-1
863,1,STEP,783729022855,783732417319,3394464,-1
864,1,STEP,783732492118,783735692884,3200766,-1
865,1,STEP,783735762884,783738888550,3125666,-1
866,1,STEP,783738961650,783741748420,2786770,-1
867,1,STEP,783741820719,783744901786,3081067,-1
868,1,STEP,783744975186,783748021853,3046667,-1
869,1,STEP,783748095852,783751544616,3448764,-1
870,1,STEP,783751620115,783754726582,3106467,-1
871,1,STEP,783754800481,783757539152,2738671,-1
872,1,STEP,783757610951,783760781417,3170466,-1
873,1,STEP,783760850117,783763848985,2998868,-1
874,1,STEP,783763921584,783766719454,2797870,-1
875,1,STEP,783766845253,783769919920,3074667,-1
876,1,STEP,783769994919,783772930988,2936069,-1
877,1,STEP,783773003387,783775851757,2848370,-1
878,1,STEP,783775925556,783779289521,3363965,-1
879,1,STEP,783779364120,783782291089,2926969,-1
880,1,STEP,783782363288,783785847451,3484163,-1
881,1,STEP,783785931750,783788661221,2729471,-1
882,1,STEP,783788732120,783791343492,2611372,-1
883,1,STEP,783791416792,783794220962,2804170,-1
884,1,STEP,783794293861,783798194620,3900759,-1
885,1,STEP,783798336118,783803952058,5615940,-1
886,1,STEP,783804077257,783807493421,3416164,-1
887,1,STEP,783807570520,783810643487,3072967,-1
888,1,STEP,783810717586,783814097450,3379864,-1
889,1,STEP,783814225149,783819191996,4966847,-1
890,1,STEP,783819323095,783823839747,4516652,-1
891,1,STEP,783823970345,783829044291,5073946,-1
892,1,STEP,783829173990,783833761141,4587151,-1
893,1,STEP,783833901840,783837536701,3634861,-1
894,1,STEP,783837666800,783842199051,4532251,-1
895,1,STEP,783842329950,783846450506,4120556,-1
896,1,STEP,783846579905,783851448253,4868348,-1
897,1,STEP,783851576352,783856408800,4832448,-1
898,1,STEP,783856539699,783860647955,4108256,-1
899,1,STEP,783860775254,783866174696,5399442,-1
900,1,STEP,783866302695,783870246953,3944258,-1
901,1,STEP,783870371652,783875068202,4696550,-1
902,1,STEP,783875196101,783879545554,4349453,-1
903,1,STEP,783879668253,783884229404,4561151,-1
904,1,STEP,783884355703,783889216351,4860648,-1
905,1,STEP,783889346150,783893609405,4263255,-1
906,1,STEP,783893741503,783897944359,4202856,-1
907,1,STEP,783898063657,783902623409,4559752,-1
908,1,STEP,783902745908,783906684666,3938758,-1
909,1,STEP,783906806364,783910550125,3743761,-1
910,1,STEP,783910671623,783914502982,3831359,-1
911,1,STEP,783914626481,783919530329,4903848,-1
912,1,STEP,783919652528,783923146491,3493963,-1
913,1,STEP,783923269989,783927645543,4375554,-1
914,1,STEP,783927765841,783932137095,4371254,-1
915,1,STEP,783932258594,783936588748,4330154,-1
916,1,STEP,783936711846,783940546805,3834959,-1
917,1,STEP,783940674204,783944399364,3725160,-1
918,1,STEP,783944521863,783948979716,4457853,-1
919,1,STEP,783949106814,783954023362,4916548,-1
920,1,STEP,783954152261,783959062709,4910448,-1
921,1,STEP,783959191907,783963902857,4710950,-1
922,1,STEP,783963978956,783966746027,2767071,-1
923,1,STEP,783966820426,783970144491,3324065,-1
924,1,STEP,783970220790,783972829862,2609072,-1
925,1,STEP,783972903861,783976217826,3313965,-1
926,1,STEP,783976292625,783979394092,3101467,-1
927,1,STEP,783979466992,783982045064,2578072,-1
928,1,STEP,783982118063,783984815135,2697072,-1
929,1,STEP,783984885934,783987951201,3065267,-1
930,1,STEP,783988024600,783990876070,2851470,-1
931,1,STEP,783990950069,783993630641,2680572,-1
932,1,STEP,783993703840,783997184903,3481063,-1
933,1,STEP,783997259002,784000419469,3160467,-1
934,1,STEP,784000488768,784003751233,3262465,-1
935,1,STEP,784003826732,784007367595,3540863,-1
936,1,STEP,784007437594,784011043356,3605762,-1
937,1,STEP,784011118455,784014157823,3039368,-1
938,1,STEP,784014232722,784017741284,3508562,-1
939,1,STEP,784017825884,784020644254,2818370,-1
940,1,STEP,784020718653,784024012318,3293665,-1
941,1,STEP,784024099517,784027429481,3329964,-1
942,1,STEP,784027567880,784032121631,4553751,-1
943,1,STEP,784032258430,784036145089,3886659,-1
944,1,STEP,784036218688,784039419254,3200566,-1
945,1,STEP,784039496653,784043459911,3963258,-1
946,1,STEP,784043537010,784047542267,4005257,-1
947,1,STEP,784047658066,784050902232,3244166,-1
948,1,STEP,784051011331,784054671492,3660161,-1
949,1,STEP,784054745991,784058439252,3693261,-1
950,1,STEP,784058513151,784061922015,3408864,-1
951,1,STEP,784061997714,784065028481,3030767,-1
952,1,STEP,784065102181,784068685443,3583262,-1
953,1,STEP,784068762042,784071193016,2430974,-1
954,1,STEP,784071263415,784074570480,3307065,-1
955,1,STEP,784074646779,784077481749,2834970,-1
956,1,STEP,784077553348,784081203909,3650561,-1
957,1,STEP,784081278509,784084447175,3168666,-1
958,1,STEP,784084520974,784087551342,3030368,-1
959,1,STEP,784087625741,784090517210,2891469,-1
960,1,STEP,784090590210,784093681677,3091467,-1
961,1,STEP,784093751676,784097180540,3428864,-1
962,1,STEP,784097256539,784100519704,3263165,-1
963,1,STEP,784100594703,784103479773,2885070,-1
964,1,STEP,784103551872,784106638339,3086467,-1
965,1,STEP,784106711238,784110191701,3480463,-1
966,1,STEP,784110265300,784113295468,3030168,-1
967,1,STEP,784113368067,784116189237,2821170,-1
968,1,STEP,784116263437,784119303204,3039767,-1
969,1,STEP,784119377103,784121906077,2528974,-1
970,1,STEP,784121977176,784124633448,2656272,-1
971,1,STEP,784124703247,784127629916,2926669,-1
972,1,STEP,784127703915,784130718883,3014968,-1
973,1,STEP,784130790482,784133680351,2889869,-1
974,1,STEP,784133753951,784136758419,3004468,-1
975,1,STEP,784136832718,784139894885,3062167,-1
976,1,STEP,784139970084,784143131451,3161367,-1
977,1,STEP,784143206750,784145911021,2704271,-1
978,1,STEP,784145985420,784149109287,3123867,-1
979,1,STEP,784149182886,784152341053,3158167,-1
980,1,STEP,784152415252,784155532119,3116867,-1
981,1,STEP,784155606018,784158390788,2784770,-1
982,1,STEP,784158465288,784161500455,3035167,-1
983,1,STEP,784161575855,784164744721,3168866,-1
984,1,STEP,784164820020,784167600091,2780071,-1
985,1,STEP,784167674390,784170577959,2903569,-1
986,1,STEP,784170651758,784173267430,2615672,-1
987,1,STEP,784173340329,784176599995,3259666,-1
988,1,STEP,784176673194,784179718562,3045368,-1
989,1,STEP,784179792261,784182736230,2943969,-1
990,1,STEP,784182811729,784185331402,2519673,-1
991,1,STEP,784185404301,784188392469,2988168,-1
992,1,STEP,784188466269,784191361038,2894769,-1
993,1,STEP,784191434937,784194372906,2937969,-1
994,1,STEP,784194446005,784197146976,2700971,-1
995,1,STEP,784197219776,784200739438,3519662,-1
996,1,STEP,784200813937,784203708706,2894769,-1
997,1,STEP,784203783606,784206870773,3087167,-1
998,1,STEP,784206946472,784209955640,3009168,-1
999,1,STEP,784210030139,784213094607,3064468,-1
